id,bank,counterparty,posted,new_balance,value,type,user,account_type
d0571e76-23f8-4133-a9d2-e0866f9ea7af,bank_d_02.uk,INCOME,2016-05-16,93000.00,33000.00,INCOME,Joe Williams,CURRENT
b426e363-bd29-49e0-9d41-e8906fa3d6a2,bank_d_02.uk,Comcast,2016-05-17,90530.30,-2469.70,utility,Joe Williams,CURRENT
a35a238d-038f-4d45-bd48-6548d36914b1,bank_d_02.uk,Tuition,2016-05-19,88778.64,-1751.66,education,Joe Williams,CURRENT
8ca9563f-5e08-47e2-bc19-bd2e27309616,bank_d_02.uk,Amazon.com,2016-05-20,88033.02,-745.62,entertainment,Joe Williams,CURRENT
d0ff7ee9-92a9-48eb-a7b9-efdb06bfeb52,bank_d_02.uk,K&L Wines,2016-05-30,87775.08,-257.94,gift,Joe Williams,CURRENT
5de4bed3-b578-4e50-a3df-57482f132a84,bank_d_02.uk,J. Crew,2016-05-31,86721.74,-1053.34,clothing,Joe Williams,CURRENT
c6dc74b2-8315-4c8b-97ff-c9f4bee35df6,bank_d_02.uk,Dr. Jackson,2016-06-02,85520.13,-1201.61,health,Joe Williams,CURRENT
3d8ec263-0b99-4fac-91ad-a9a04133c85b,bank_d_02.uk,In-N-Out Burger,2016-06-03,84846.51,-673.62,food,Joe Williams,CURRENT
cef801c0-a0c4-4470-8274-8e8c2a0c7551,bank_d_02.uk,In-N-Out Burger,2016-06-11,84216.96,-629.55,food,Joe Williams,CURRENT
cf129122-4e38-4035-bc95-544f84669458,bank_d_02.uk,In-N-Out Burger,2016-06-12,83728.36,-488.60,food,Joe Williams,CURRENT
942b8b90-9b01-4784-90ba-d2032c2b316a,bank_d_02.uk,In-N-Out Burger,2016-06-14,83059.97,-668.39,food,Joe Williams,CURRENT
639cccc5-5673-4c62-86ae-6782a80ec902,bank_d_02.uk,INCOME,2016-05-16,2030000.00,30000.00,INCOME,Joe Williams,SAVING
4c63061b-6123-4e78-ac58-70ed1ecbcfa4,bank_d_00.uk,INCOME,2016-05-16,620000.00,20000.00,INCOME,Ammy Williams,SAVING
c27cf0fe-3543-4699-ab36-832477bdda39,bank_d_01.uk,INCOME,2016-05-16,210000.00,60000.00,INCOME,Ammy Williams,CURRENT
c5d7d8ad-3585-4d44-89a5-ff7dfb9a868f,bank_d_01.uk,Whole Foods,2016-05-16,209449.21,-550.79,food,Ammy Williams,CURRENT
06b309b3-d816-485d-9ae4-d5959b06cd21,bank_d_01.uk,RENT,2016-05-16,189449.21,-20000.00,RENT,Ammy Williams,CURRENT
222548bb-91b2-4ff4-adfc-766e49b2c3ec,bank_d_01.uk,AMC Theaters,2016-05-19,189049.16,-400.05,entertainment,Ammy Williams,CURRENT
ecaf0994-1a7b-47de-8830-86f46049949f,bank_d_01.uk,Late Fee,2016-05-19,188625.20,-423.96,fee,Ammy Williams,CURRENT
b3efab64-16a5-4c05-9881-e639e4559b22,bank_d_01.uk,The Gap,2016-05-21,187436.55,-1188.65,clothing,Ammy Williams,CURRENT
ca62677c-9fd3-4b29-9ca8-2340d3306c1e,bank_d_01.uk,Dr. Phillips,2016-05-26,186165.03,-1271.52,health,Ammy Williams,CURRENT
07ab2176-6fa9-4ee4-8ff5-55ff1195308c,bank_d_01.uk,Shell,2016-05-27,185277.20,-887.83,auto,Ammy Williams,CURRENT
b2755e90-bd89-40a7-8a2f-9a87665f2cbf,bank_d_01.uk,Whole Foods,2016-05-30,184933.46,-343.74,food,Ammy Williams,CURRENT
7c8358c9-0789-459b-af6f-321b49ab7507,bank_d_01.uk,Campus Books,2016-05-31,183845.33,-1088.13,education,Ammy Williams,CURRENT
f5612b7c-bb53-4346-9944-529412d6bf6f,bank_d_01.uk,Comcast,2016-06-05,181601.14,-2244.19,utility,Ammy Williams,CURRENT
e56a0e9c-b19b-4bd5-9b72-05e5782d8345,bank_d_01.uk,Whole Foods,2016-06-08,181258.20,-342.94,food,Ammy Williams,CURRENT
99503988-20b4-4a14-8954-eb468e9c48a9,bank_d_01.uk,Whole Foods,2016-06-08,180948.78,-309.42,food,Ammy Williams,CURRENT
16422e09-9c84-438b-b142-63580ceaf879,bank_d_01.uk,K&L Wines,2016-06-12,180621.00,-327.78,gift,Ammy Williams,CURRENT
03cdea4a-0c9d-4027-872b-6de85a05b30f,bank_d_01.uk,Whole Foods,2016-06-14,179921.33,-699.67,food,Ammy Williams,CURRENT
7c1a3097-ad47-45ad-8d3b-a62bbd3db16a,bank_d_02.uk,INCOME,2016-06-15,116059.97,33000.00,INCOME,Joe Williams,CURRENT
9d347871-2815-4653-8533-263af38d689e,bank_d_02.uk,Neiman-Marcus,2016-06-15,115584.66,-475.31,gift,Joe Williams,CURRENT
c46c0d47-234e-4d44-81ad-b7f65d489004,bank_d_02.uk,Olive Garden,2016-06-18,115064.77,-519.89,food,Joe Williams,CURRENT
b41573a6-cb95-46cd-91ff-0aab972003a9,bank_d_02.uk,Campus Books,2016-06-18,113989.32,-1075.45,education,Joe Williams,CURRENT
d3d49c49-8ab9-4d46-af02-f0a7151068c2,bank_d_02.uk,Metreon Theaters,2016-06-19,113404.53,-584.79,entertainment,Joe Williams,CURRENT
1f543cff-070a-4ada-be38-854b6ea90aee,bank_d_02.uk,Olive Garden,2016-06-21,112981.08,-423.45,food,Joe Williams,CURRENT
3bb8684d-97f6-48aa-8a14-ac6cbd1d9119,bank_d_02.uk,Olive Garden,2016-06-24,112538.99,-442.09,food,Joe Williams,CURRENT
5f538ec6-7f25-4036-a1cc-2d4f1774b40d,bank_d_02.uk,Olive Garden,2016-06-24,112179.56,-359.43,food,Joe Williams,CURRENT
35c7a2fb-cb81-4a73-9583-c0fa79850aaa,bank_d_02.uk,Chevron,2016-06-25,110206.83,-1972.73,auto,Joe Williams,CURRENT
78ad96f1-758c-4749-bbc1-d2705524f47d,bank_d_02.uk,Dr. Jackson,2016-07-04,108912.12,-1294.71,health,Joe Williams,CURRENT
00723257-c0f0-4db1-a005-e1441467858f,bank_d_02.uk,The Gap,2016-07-05,107961.80,-950.32,clothing,Joe Williams,CURRENT
df985fb0-7d05-4e7f-b0f1-38135bb092d4,bank_d_02.uk,Olive Garden,2016-07-13,107618.00,-343.80,food,Joe Williams,CURRENT
c276e97c-91aa-42e4-9a96-e01bc92753a8,bank_d_02.uk,Comcast,2016-07-14,105125.64,-2492.36,utility,Joe Williams,CURRENT
ec1bc5a4-e78b-463b-b716-60a7c149a401,bank_d_02.uk,Olive Garden,2016-07-15,104794.13,-331.51,food,Joe Williams,CURRENT
29131f0a-848e-4eb0-8352-365af4bbe178,bank_d_02.uk,INCOME,2016-06-15,2060000.00,30000.00,INCOME,Joe Williams,SAVING
1cddf315-7b18-4cc8-8b19-33e5b743ae47,bank_d_00.uk,INCOME,2016-06-15,640000.00,20000.00,INCOME,Ammy Williams,SAVING
9a97680c-6f87-4a73-a799-f8e6cbfe4d3c,bank_d_01.uk,INCOME,2016-06-15,239921.33,60000.00,INCOME,Ammy Williams,CURRENT
c815bec8-73bd-4285-88cf-636d79681bd0,bank_d_01.uk,AT&T,2016-06-15,238211.14,-1710.19,utility,Ammy Williams,CURRENT
2254f6b6-e036-4583-be77-0fa4689bc634,bank_d_01.uk,RENT,2016-06-15,218211.14,-20000.00,RENT,Ammy Williams,CURRENT
3151b178-06c1-4fc1-911a-592b9a0090af,bank_d_01.uk,Dr. Roberts,2016-06-21,216384.58,-1826.56,health,Ammy Williams,CURRENT
700e0277-5328-43fd-a6ea-652507383d78,bank_d_01.uk,Tuition,2016-06-22,215195.51,-1189.07,education,Ammy Williams,CURRENT
cfdda885-c45a-46ba-89b0-8a9a942f906a,bank_d_01.uk,In-N-Out Burger,2016-06-26,214694.65,-500.86,food,Ammy Williams,CURRENT
66af2935-9b76-4e9a-9c31-46c6c9e62ee7,bank_d_01.uk,In-N-Out Burger,2016-06-28,214095.04,-599.61,food,Ammy Williams,CURRENT
93e22757-ecd4-4030-af52-45f67bdda70b,bank_d_01.uk,In-N-Out Burger,2016-07-01,213518.23,-576.81,food,Ammy Williams,CURRENT
4d41c0a9-aa6c-4a09-bc6d-a9239caef84f,bank_d_01.uk,In-N-Out Burger,2016-07-08,212908.12,-610.11,food,Ammy Williams,CURRENT
cdbf4ae8-1e4f-4dd8-9503-329aa66625ae,bank_d_01.uk,Pep Boys,2016-07-08,211760.88,-1147.24,auto,Ammy Williams,CURRENT
cc2eac9d-c507-4636-9a0c-9eac97481e81,bank_d_01.uk,J. Crew,2016-07-09,210866.16,-894.72,clothing,Ammy Williams,CURRENT
2d37f8a8-bc9e-4fc7-af84-55b298ccd598,bank_d_01.uk,iTunes Music Store,2016-07-12,210460.12,-406.04,entertainment,Ammy Williams,CURRENT
ef0a809c-6b70-459f-82c0-4c20ab300d04,bank_d_01.uk,In-N-Out Burger,2016-07-13,209960.25,-499.87,food,Ammy Williams,CURRENT
bf7d94a8-6eee-40b0-b41b-8f94414f0f3c,bank_d_02.uk,INCOME,2016-07-15,137794.13,33000.00,INCOME,Joe Williams,CURRENT
832b3fde-25aa-4f57-85e9-0cdfc005a407,bank_d_02.uk,Neiman-Marcus,2016-07-16,137457.51,-336.62,gift,Joe Williams,CURRENT
b616ca51-fa74-467a-a502-65ed7479bf36,bank_d_02.uk,Shell,2016-07-19,136024.56,-1432.95,auto,Joe Williams,CURRENT
bccef9cb-0f99-454e-88b7-42e8d1b5deed,bank_d_02.uk,Trader Joe's,2016-07-23,135615.36,-409.20,food,Joe Williams,CURRENT
9883886f-d8d8-48cd-9088-5cf0180cb9fc,bank_d_02.uk,Annual Fee,2016-07-24,135322.29,-293.07,fee,Joe Williams,CURRENT
062305c4-6fa8-413c-9e09-4e6dbe80a19d,bank_d_02.uk,,2016-07-26,133170.03,-2152.26,utility,Joe Williams,CURRENT
e7a3e01e-bde0-42e0-9523-a71faa9fa63b,bank_d_02.uk,Amazon.com,2016-07-28,132522.80,-647.23,entertainment,Joe Williams,CURRENT
65f47756-a1f9-4c7c-9e47-de78b75cd51c,bank_d_02.uk,Trader Joe's,2016-07-29,131940.08,-582.72,food,Joe Williams,CURRENT
6225f581-7b90-4eb0-8e61-9dc1ca250259,bank_d_02.uk,Trader Joe's,2016-07-31,131434.31,-505.77,food,Joe Williams,CURRENT
2e88d721-efcd-4ba7-8f95-ae06b9ddfe49,bank_d_02.uk,Macy's,2016-08-01,129939.06,-1495.25,clothing,Joe Williams,CURRENT
f4dbd811-0c4a-45a6-9ae0-feaba40be9d3,bank_d_02.uk,Walgreen's,2016-08-04,128552.60,-1386.46,health,Joe Williams,CURRENT
19219631-0e7e-4604-80b8-50fb38e7630f,bank_d_02.uk,Campus Books,2016-08-07,127260.39,-1292.21,education,Joe Williams,CURRENT
0fbbd497-4169-4d55-8e66-8352056731b9,bank_d_02.uk,Trader Joe's,2016-08-09,126799.56,-460.83,food,Joe Williams,CURRENT
820c5d42-7d0e-40b6-8a71-08003ed08b9f,bank_d_02.uk,INCOME,2016-07-15,2090000.00,30000.00,INCOME,Joe Williams,SAVING
a376d144-3e41-46aa-91aa-43c616993496,bank_d_00.uk,INCOME,2016-07-15,660000.00,20000.00,INCOME,Ammy Williams,SAVING
5a76ecef-3f39-48ff-830c-eef8c23292c6,bank_d_01.uk,INCOME,2016-07-15,269960.25,60000.00,INCOME,Ammy Williams,CURRENT
dd5daf7f-c869-43dd-ab49-fc570f8fbd89,bank_d_01.uk,RENT,2016-07-15,249960.25,-20000.00,RENT,Ammy Williams,CURRENT
dd9b38f3-6e24-46f2-a682-4a9f9f75afcb,bank_d_01.uk,Jiffy Lube,2016-07-16,248131.17,-1829.08,auto,Ammy Williams,CURRENT
d6215781-96d6-4973-9c4f-7da6bc4cb197,bank_d_01.uk,PG&E,2016-07-18,246126.09,-2005.08,utility,Ammy Williams,CURRENT
910b5e99-ad0f-40b2-9d9d-22fd27925ae5,bank_d_01.uk,AMC Theaters,2016-07-22,245493.47,-632.62,entertainment,Ammy Williams,CURRENT
cb77b317-c58d-4fb9-9344-22510274df60,bank_d_01.uk,Olive Garden,2016-07-31,245081.48,-411.99,food,Ammy Williams,CURRENT
f46c2b78-0ccb-48cc-a2d9-3acb9c7877db,bank_d_01.uk,Wal-Mart,2016-08-02,243093.05,-1988.43,health,Ammy Williams,CURRENT
115444ae-42e6-4b91-a32a-fddc1bf55303,bank_d_01.uk,Olive Garden,2016-08-04,242542.61,-550.44,food,Ammy Williams,CURRENT
6db9eb4d-4d99-47ea-a84f-ec1c3dbb4835,bank_d_01.uk,Olive Garden,2016-08-08,241861.58,-681.03,food,Ammy Williams,CURRENT
a866d124-100d-4881-8f48-c18ed0e33fb5,bank_d_01.uk,Olive Garden,2016-08-10,241307.66,-553.92,food,Ammy Williams,CURRENT
0c5b75b5-d12d-4033-ba9b-22d6f96f20d0,bank_d_01.uk,K&L Wines,2016-08-10,240920.21,-387.45,gift,Ammy Williams,CURRENT
4a7de949-e976-407c-9c90-bfbc48ee8da1,bank_d_01.uk,Olive Garden,2016-08-11,240577.08,-343.13,food,Ammy Williams,CURRENT
0087d193-efc8-4fb4-ba0a-a64affdda23c,bank_d_01.uk,The Gap,2016-08-11,239068.08,-1509.00,clothing,Ammy Williams,CURRENT
ff7e4b98-2a40-4934-8488-b75f5bc1550c,bank_d_01.uk,Olive Garden,2016-08-13,238387.00,-681.08,food,Ammy Williams,CURRENT
b31051bd-9c96-413a-9116-7fc8737c37fd,bank_d_01.uk,Interest Fee,2016-08-14,237934.01,-452.99,fee,Ammy Williams,CURRENT
988f6e54-5c36-4cbe-9ecb-1b483a00dedb,bank_d_02.uk,INCOME,2016-08-14,159799.56,33000.00,INCOME,Joe Williams,CURRENT
3f31d7c5-167d-4d12-88ef-8d1d2e989a0f,bank_d_02.uk,Wal-Mart,2016-08-23,158837.51,-962.05,health,Joe Williams,CURRENT
7530c912-a06f-4edc-9c81-836e0510d070,bank_d_02.uk,Banana Republic,2016-08-26,157572.37,-1265.14,clothing,Joe Williams,CURRENT
337b5041-94eb-474c-9cd7-9b6973199fa1,bank_d_02.uk,Netflix,2016-08-27,156975.87,-596.50,entertainment,Joe Williams,CURRENT
e7b0719c-c35a-4fcf-9928-82aedcda2a51,bank_d_02.uk,Interest Fee,2016-08-28,156440.04,-535.83,fee,Joe Williams,CURRENT
c8e1eed3-764a-4168-811c-93b24588199b,bank_d_02.uk,Trader Joe's,2016-08-31,155841.80,-598.24,food,Joe Williams,CURRENT
24b16be6-c5ab-4598-8de2-294b712668a0,bank_d_02.uk,Shell,2016-09-02,154206.59,-1635.21,auto,Joe Williams,CURRENT
3f6f2511-a487-4bef-92ca-d94e1caad3a6,bank_d_02.uk,Trader Joe's,2016-09-04,153592.16,-614.43,food,Joe Williams,CURRENT
346f6711-4d2e-4662-83cd-33c4b526b845,bank_d_02.uk,Registration,2016-09-08,151844.73,-1747.43,education,Joe Williams,CURRENT
f7cba4c8-f521-4fd5-bd76-e4175ff149ef,bank_d_02.uk,Trader Joe's,2016-09-10,151485.01,-359.72,food,Joe Williams,CURRENT
f6f42597-9732-48ee-b0d6-e40348f04f3a,bank_d_02.uk,Trader Joe's,2016-09-13,150942.75,-542.26,food,Joe Williams,CURRENT
88a1b8aa-38d7-4cbc-b873-625433ae37d0,bank_d_02.uk,INCOME,2016-08-14,2120000.00,30000.00,INCOME,Joe Williams,SAVING
9370f3ac-a066-4a26-b77b-5d04de0c7368,bank_d_00.uk,INCOME,2016-08-14,680000.00,20000.00,INCOME,Ammy Williams,SAVING
c55195e2-5569-4c84-8bda-cbd808903ae6,bank_d_01.uk,INCOME,2016-08-14,297934.01,60000.00,INCOME,Ammy Williams,CURRENT
6618867f-77bc-4fd4-9abb-19f28f0fe7c9,bank_d_01.uk,Safeway,2016-08-14,297224.97,-709.04,food,Ammy Williams,CURRENT
64eb56dd-721b-4821-8495-90a841f700a5,bank_d_01.uk,RENT,2016-08-14,277224.97,-20000.00,RENT,Ammy Williams,CURRENT
4a5d643c-c196-4270-9aed-32b89eedb69f,bank_d_01.uk,Safeway,2016-08-15,276510.43,-714.54,food,Ammy Williams,CURRENT
43219b46-829b-4e0a-aeaf-2571cf870e71,bank_d_01.uk,Apple Store,2016-08-22,276208.94,-301.49,gift,Ammy Williams,CURRENT
80060baa-f8a4-4b00-96ea-1329e2a77bf4,bank_d_01.uk,Safeway,2016-08-27,275774.67,-434.27,food,Ammy Williams,CURRENT
3e0f4be7-4db9-45d9-a001-9a91ac7884e7,bank_d_01.uk,Safeway,2016-08-30,275267.61,-507.06,food,Ammy Williams,CURRENT
da91bee7-14a0-4d86-8420-eaec053c3049,bank_d_01.uk,Comcast,2016-09-01,273409.99,-1857.62,utility,Ammy Williams,CURRENT
fc7b6eef-5bb5-4d71-913e-ea459fe2f6e8,bank_d_01.uk,Walgreen's,2016-09-03,271391.13,-2018.86,health,Ammy Williams,CURRENT
588a971a-d59c-472a-aef6-9bb36d36433e,bank_d_01.uk,iTunes Music Store,2016-09-04,270579.79,-811.34,entertainment,Ammy Williams,CURRENT
968bbd69-f2c9-43c6-9f87-9f0c9c6656fe,bank_d_01.uk,Safeway,2016-09-10,270189.77,-390.02,food,Ammy Williams,CURRENT
33253955-7585-448d-8844-3ea474097a2c,bank_d_01.uk,Interest Fee,2016-09-10,269922.19,-267.58,fee,Ammy Williams,CURRENT
cf473277-0815-47fd-aa3a-5586dae35be8,bank_d_01.uk,Nordstrom,2016-09-11,268742.60,-1179.59,clothing,Ammy Williams,CURRENT
96842b65-82d7-4fcf-b86d-8b1fb1d8cc63,bank_d_01.uk,Shell,2016-09-12,267557.44,-1185.16,auto,Ammy Williams,CURRENT
e24c183f-ceb9-429c-be61-c8d23fcc2d96,bank_d_01.uk,Amazon.com,2016-09-12,266562.22,-995.22,education,Ammy Williams,CURRENT
e8c422a9-a8d9-4c08-98fa-13ec2f66def2,bank_d_02.uk,INCOME,2016-09-13,183942.75,33000.00,INCOME,Joe Williams,CURRENT
d959f493-2270-4ded-897b-78b41971f22d,bank_d_02.uk,Safeway,2016-09-17,183298.17,-644.58,food,Joe Williams,CURRENT
dfc707ac-19db-4b6a-89e4-f7e809eb5964,bank_d_02.uk,Kenneth Cole,2016-09-18,182292.28,-1005.89,clothing,Joe Williams,CURRENT
5f29b44d-c83d-456e-8cca-a503953bbef4,bank_d_02.uk,Safeway,2016-09-21,181803.55,-488.73,food,Joe Williams,CURRENT
279fba90-cc3a-459a-8ade-57b66e19da59,bank_d_02.uk,Safeway,2016-09-22,181169.13,-634.42,food,Joe Williams,CURRENT
39a16195-c835-47b0-833b-cda125b70f4a,bank_d_02.uk,Dr. Martins,2016-09-23,179835.84,-1333.29,health,Joe Williams,CURRENT
ad201fd6-d2f2-41c5-9afa-84f90bf767d3,bank_d_02.uk,Netflix,2016-09-26,179065.73,-770.11,entertainment,Joe Williams,CURRENT
1ed8c7ae-02ba-43f8-8e79-2ad5d43474c9,bank_d_02.uk,,2016-09-27,177963.90,-1101.83,utility,Joe Williams,CURRENT
305c7a13-31b8-42f3-b8d2-ecdd210e5292,bank_d_02.uk,Campus Books,2016-09-28,176355.09,-1608.81,education,Joe Williams,CURRENT
55cf3ea1-e8a2-4bc8-b361-890c8044e59d,bank_d_02.uk,Amazon.com,2016-09-29,175957.38,-397.71,gift,Joe Williams,CURRENT
4af08cde-8e13-41d7-b2af-fc7faecbd337,bank_d_02.uk,Safeway,2016-10-02,175500.07,-457.31,food,Joe Williams,CURRENT
0fd74106-f527-43bb-b1f9-21869de0e9c7,bank_d_02.uk,Shell,2016-10-07,174105.25,-1394.82,auto,Joe Williams,CURRENT
cef54adb-8dd3-4213-85b0-2484fee27a89,bank_d_02.uk,INCOME,2016-09-13,2150000.00,30000.00,INCOME,Joe Williams,SAVING
7081ccf6-be10-4c12-9663-b15eead0a4ac,bank_d_00.uk,INCOME,2016-09-13,700000.00,20000.00,INCOME,Ammy Williams,SAVING
bce34496-5d7e-4326-9b6a-f8d04ec66574,bank_d_01.uk,INCOME,2016-09-13,326562.22,60000.00,INCOME,Ammy Williams,CURRENT
d12ff47b-5c3c-4cda-a749-5740c88d3b0f,bank_d_01.uk,RENT,2016-09-13,306562.22,-20000.00,RENT,Ammy Williams,CURRENT
92ebf49a-54f3-4b2b-b3ff-387b535a8b82,bank_d_01.uk,Olive Garden,2016-09-16,306028.68,-533.54,food,Ammy Williams,CURRENT
494275c0-845b-4908-923a-e0e2b3d6e5c3,bank_d_01.uk,Olive Garden,2016-09-20,305421.46,-607.22,food,Ammy Williams,CURRENT
8223a9c5-1b46-409d-b2ca-5fafad2bc887,bank_d_01.uk,Olive Garden,2016-09-21,304738.12,-683.34,food,Ammy Williams,CURRENT
afcbfff7-52c4-4e76-aae7-70e1484e7e12,bank_d_01.uk,Dr. Roberts,2016-09-23,303488.98,-1249.14,health,Ammy Williams,CURRENT
86203fe1-0834-4af4-86d8-c61d38b5c7f3,bank_d_01.uk,Late Fee,2016-09-23,303115.83,-373.15,fee,Ammy Williams,CURRENT
4a8baf97-ed96-42f4-9de8-ad5b8935a74c,bank_d_01.uk,iTunes Music Store,2016-09-25,302525.81,-590.02,entertainment,Ammy Williams,CURRENT
c0017b68-b842-4906-b0a6-148312e841de,bank_d_01.uk,The Crucible,2016-09-25,300856.36,-1669.45,education,Ammy Williams,CURRENT
da53ab00-1696-43e7-bdc7-059700adf252,bank_d_01.uk,Pep Boys,2016-09-28,299141.55,-1714.81,auto,Ammy Williams,CURRENT
9507fde6-5149-4e24-bc23-b4c05000c239,bank_d_01.uk,Nordstrom,2016-10-02,298836.43,-305.12,gift,Ammy Williams,CURRENT
96f1a0f9-61c8-4a51-8573-277f79262b42,bank_d_01.uk,Olive Garden,2016-10-12,298296.04,-540.39,food,Ammy Williams,CURRENT
7989c5a1-48b8-4fed-9436-16b391578555,bank_d_01.uk,AT&T,2016-10-12,296018.89,-2277.15,utility,Ammy Williams,CURRENT
c8b23fe2-ab06-447e-b57a-ecc4696ade80,bank_d_01.uk,Olive Garden,2016-10-13,295622.20,-396.69,food,Ammy Williams,CURRENT
32ecdcd2-163f-4edf-a483-a2102017639f,bank_d_01.uk,Kenneth Cole,2016-10-13,294470.52,-1151.68,clothing,Ammy Williams,CURRENT
7e326292-d24b-47a9-b32c-a169d034bf8c,bank_d_02.uk,INCOME,2016-10-13,207105.25,33000.00,INCOME,Joe Williams,CURRENT
3a625744-4c95-4851-86ef-baf7c9fef673,bank_d_02.uk,Whole Foods,2016-10-16,206789.79,-315.46,food,Joe Williams,CURRENT
311e2dbf-bc2c-4a3c-9bc2-edc9a93e3dd7,bank_d_02.uk,Macy's,2016-10-16,205963.52,-826.27,clothing,Joe Williams,CURRENT
723be1b8-1bad-4e14-907c-6d4666c0a6c6,bank_d_02.uk,Whole Foods,2016-10-17,205629.37,-334.15,food,Joe Williams,CURRENT
e0960c70-7005-4295-8d17-01bd4abae1b9,bank_d_02.uk,Whole Foods,2016-10-21,205004.88,-624.49,food,Joe Williams,CURRENT
7e0e9069-a80d-4894-b303-ad2488452151,bank_d_02.uk,Whole Foods,2016-10-24,204376.85,-628.03,food,Joe Williams,CURRENT
85f9256e-3036-4fbe-a1e9-854e354b13d8,bank_d_02.uk,Verizon,2016-10-25,203208.56,-1168.29,utility,Joe Williams,CURRENT
cc2aae62-ce73-45d6-a258-81ef01157260,bank_d_02.uk,iTunes Music Store,2016-10-28,202519.56,-689.00,entertainment,Joe Williams,CURRENT
7cfc1c71-e3d3-451b-acca-fc3825ecbf05,bank_d_02.uk,Annual Fee,2016-10-30,202146.49,-373.07,fee,Joe Williams,CURRENT
9cd16423-ed5a-4572-b18c-302f4e4ad99d,bank_d_02.uk,Dr. Martins,2016-10-31,200614.95,-1531.54,health,Joe Williams,CURRENT
f285338c-9614-412e-af01-a3f3e37fca42,bank_d_02.uk,Neiman-Marcus,2016-11-02,200241.08,-373.87,gift,Joe Williams,CURRENT
b66c65b6-6091-40ef-b28b-d6c95e9d6f4f,bank_d_02.uk,INCOME,2016-10-13,2180000.00,30000.00,INCOME,Joe Williams,SAVING
95afadf6-662e-4e4a-8de4-c003d796f7eb,bank_d_00.uk,INCOME,2016-10-13,720000.00,20000.00,INCOME,Ammy Williams,SAVING
f33e6fb5-7558-41ef-b8aa-05aa3ee89b64,bank_d_01.uk,INCOME,2016-10-13,354470.52,60000.00,INCOME,Ammy Williams,CURRENT
d9f1be8c-c55c-49b0-85a9-bcb93e6bc3e5,bank_d_01.uk,Whole Foods,2016-10-13,353817.03,-653.49,food,Ammy Williams,CURRENT
20b68883-1c57-410d-8b86-947a0419c012,bank_d_01.uk,RENT,2016-10-13,333817.03,-20000.00,RENT,Ammy Williams,CURRENT
3254621f-2452-49f0-ba6c-57ea503fe16c,bank_d_01.uk,PG&E,2016-10-14,331788.94,-2028.09,utility,Ammy Williams,CURRENT
55f97beb-bfce-4507-b697-83cb1ba5ec7b,bank_d_01.uk,Bank Fee,2016-10-15,331532.87,-256.07,fee,Ammy Williams,CURRENT
edd17970-4080-442f-9277-6c974a09b159,bank_d_01.uk,Whole Foods,2016-10-17,331011.05,-521.82,food,Ammy Williams,CURRENT
e5e72712-ec49-4c8c-9e49-68966dcb7c18,bank_d_01.uk,Whole Foods,2016-10-19,330398.76,-612.29,food,Ammy Williams,CURRENT
c562077f-9f9d-4f00-aeca-dbc524ed816e,bank_d_01.uk,Dr. Jackson,2016-10-22,328830.46,-1568.30,health,Ammy Williams,CURRENT
2ccf7839-712d-41d4-8a94-abc0ec8a56ec,bank_d_01.uk,Rhapsody,2016-10-22,328079.33,-751.13,entertainment,Ammy Williams,CURRENT
edadc59c-7548-4251-bed5-d0492e49504c,bank_d_01.uk,Amazon.com,2016-10-25,326864.31,-1215.02,education,Ammy Williams,CURRENT
2d2fccac-cd4c-4bbd-8162-6f2164b69db8,bank_d_01.uk,Arco,2016-11-04,326012.67,-851.64,auto,Ammy Williams,CURRENT
69784237-1982-442f-8b58-7ef87a7c62ce,bank_d_01.uk,Whole Foods,2016-11-05,325446.67,-566.00,food,Ammy Williams,CURRENT
88dc8a4d-8905-45f9-a970-38708b835dbd,bank_d_01.uk,Macy's,2016-11-09,324021.60,-1425.07,clothing,Ammy Williams,CURRENT
bdfcffc1-a823-4b18-b1a7-7dd6862942f7,bank_d_02.uk,INCOME,2016-11-12,233241.08,33000.00,INCOME,Joe Williams,CURRENT
52d0539e-4ede-4945-b17e-09fb1351fa04,bank_d_02.uk,PG&E,2016-11-13,230797.63,-2443.45,utility,Joe Williams,CURRENT
fd587234-6743-456b-b739-736f88b93803,bank_d_02.uk,Rhapsody,2016-11-17,230405.74,-391.89,entertainment,Joe Williams,CURRENT
c3b0314e-2ef2-4cf8-9985-779d5a2b5e97,bank_d_02.uk,Nordstrom,2016-11-21,229596.59,-809.15,clothing,Joe Williams,CURRENT
e26e84d0-eaf6-45ce-a738-e232fd5fd702,bank_d_02.uk,Starbucks,2016-11-23,229288.37,-308.22,food,Joe Williams,CURRENT
ac7f3c38-5629-4f99-9812-c5711a4d5a32,bank_d_02.uk,Jiffy Lube,2016-11-25,227839.19,-1449.18,auto,Joe Williams,CURRENT
978cc9c6-6108-435f-a5e2-d6eec19fe8e5,bank_d_02.uk,Registration,2016-11-29,226103.03,-1736.16,education,Joe Williams,CURRENT
aca0ca3a-e838-4c25-9c3f-7de6a68e2046,bank_d_02.uk,Starbucks,2016-12-02,225468.83,-634.20,food,Joe Williams,CURRENT
70f89e48-db17-44a5-aa00-a86333f81659,bank_d_02.uk,Monthly Fee,2016-12-02,225189.41,-279.42,fee,Joe Williams,CURRENT
ec808dac-2312-4fe9-a0ea-ee5d3588cddd,bank_d_02.uk,Wal-Mart,2016-12-03,224240.55,-948.86,health,Joe Williams,CURRENT
57a483a4-1140-4541-a739-73d92b245f4d,bank_d_02.uk,Starbucks,2016-12-04,223772.90,-467.65,food,Joe Williams,CURRENT
df3b4bf5-1701-4925-b4b7-dc4b2a20adfc,bank_d_02.uk,Starbucks,2016-12-12,223126.08,-646.82,food,Joe Williams,CURRENT
657cb03d-42ae-4271-b271-693cdf61cb18,bank_d_02.uk,INCOME,2016-11-12,2210000.00,30000.00,INCOME,Joe Williams,SAVING
522ea3a3-fb75-4b69-b2b6-859de63a5ea1,bank_d_00.uk,INCOME,2016-11-12,740000.00,20000.00,INCOME,Ammy Williams,SAVING
11423834-ac20-4d8a-8c49-ee70bc071dec,bank_d_01.uk,INCOME,2016-11-12,384021.60,60000.00,INCOME,Ammy Williams,CURRENT
b5a1f7bc-92e9-4b04-b7b5-ab109c3a6f1f,bank_d_01.uk,Netflix,2016-11-12,383482.18,-539.42,entertainment,Ammy Williams,CURRENT
1e63f372-44b2-48d2-93ed-41a494856a4d,bank_d_01.uk,RENT,2016-11-12,363482.18,-20000.00,RENT,Ammy Williams,CURRENT
9fda56df-f9d1-4c59-9619-d402dca856f6,bank_d_01.uk,In-N-Out Burger,2016-11-13,363173.62,-308.56,food,Ammy Williams,CURRENT
750a1fde-b464-4714-8dde-a9c6d8a2f753,bank_d_01.uk,Banana Republic,2016-11-20,362115.39,-1058.23,clothing,Ammy Williams,CURRENT
d313a353-0b5b-4d82-ae23-a24f024076b8,bank_d_01.uk,In-N-Out Burger,2016-11-26,361584.10,-531.29,food,Ammy Williams,CURRENT
878b0d4b-8647-482e-beb8-70f8d7b70ccd,bank_d_01.uk,Amazon.com,2016-11-27,360749.32,-834.78,education,Ammy Williams,CURRENT
70759137-edf9-4902-a87f-0b1e2c4e4ab9,bank_d_01.uk,Verizon,2016-11-28,359179.15,-1570.17,utility,Ammy Williams,CURRENT
1eb51e97-c984-485e-88c5-51f891e4f455,bank_d_01.uk,In-N-Out Burger,2016-11-29,358544.72,-634.43,food,Ammy Williams,CURRENT
5fb5e283-91ab-4c43-9811-8c45805d680a,bank_d_01.uk,In-N-Out Burger,2016-11-30,358131.57,-413.15,food,Ammy Williams,CURRENT
dd6cbbe7-3b72-4837-89a5-79dea29a31fb,bank_d_01.uk,Dr. Roberts,2016-12-08,356662.21,-1469.36,health,Ammy Williams,CURRENT
ab50c9e8-81d7-4f17-a04b-338f7efd681f,bank_d_01.uk,In-N-Out Burger,2016-12-11,356056.24,-605.97,food,Ammy Williams,CURRENT
3f6c0d9a-6d7f-471a-868c-fb3119f65232,bank_d_01.uk,In-N-Out Burger,2016-12-12,355433.39,-622.85,food,Ammy Williams,CURRENT
93783ec6-a4d8-42c8-bb59-30fdf2e55c04,bank_d_02.uk,INCOME,2016-12-12,256126.08,33000.00,INCOME,Joe Williams,CURRENT
f36f5855-9751-4cb2-997e-eb5fd4e85477,bank_d_02.uk,Chevron,2016-12-14,255015.11,-1110.97,auto,Joe Williams,CURRENT
5a99e865-714d-41f2-bd63-aa94a69f0991,bank_d_02.uk,Metreon Theaters,2016-12-19,254491.33,-523.78,entertainment,Joe Williams,CURRENT
c8b16fd2-ac10-4fad-a334-60df1ce2f457,bank_d_02.uk,Starbucks,2016-12-24,253919.72,-571.61,food,Joe Williams,CURRENT
ad120fca-3964-4245-869f-24670c926c2f,bank_d_02.uk,Late Fee,2016-12-26,253439.11,-480.61,fee,Joe Williams,CURRENT
a865ecea-ff56-4644-bfee-345e7c01b1bb,bank_d_02.uk,J. Crew,2017-01-02,252559.18,-879.93,clothing,Joe Williams,CURRENT
4ca38109-6875-4949-b6a4-bd333b89c456,bank_d_02.uk,Dr. Roberts,2017-01-03,250956.75,-1602.43,health,Joe Williams,CURRENT
e09dce42-4f67-444a-8398-355ca9d166dd,bank_d_02.uk,Starbucks,2017-01-06,250409.66,-547.09,food,Joe Williams,CURRENT
28d9cd48-2506-4568-bd05-8c860c83e3a6,bank_d_02.uk,Apple Store,2017-01-06,249951.61,-458.05,gift,Joe Williams,CURRENT
214ff837-672c-4641-86d7-5b16f46e0938,bank_d_02.uk,Starbucks,2017-01-07,249636.73,-314.88,food,Joe Williams,CURRENT
6051968d-ebb9-4b82-a4fc-cb17d56efd68,bank_d_02.uk,Starbucks,2017-01-08,249187.65,-449.08,food,Joe Williams,CURRENT
04ced794-19b5-45a1-adcf-56610018cde5,bank_d_02.uk,INCOME,2016-12-12,2240000.00,30000.00,INCOME,Joe Williams,SAVING
dc0b750a-a628-4e47-b2d6-d62d021be2b1,bank_d_00.uk,INCOME,2016-12-12,760000.00,20000.00,INCOME,Ammy Williams,SAVING
95f4f264-c21e-4fc9-b924-01cb207f90e5,bank_d_01.uk,INCOME,2016-12-12,415433.39,60000.00,INCOME,Ammy Williams,CURRENT
1d62b9cf-510e-440d-91a4-17b498e85083,bank_d_01.uk,RENT,2016-12-12,395433.39,-20000.00,RENT,Ammy Williams,CURRENT
e60f71d2-8fd3-4a8a-a6d6-872d7d6642ff,bank_d_01.uk,Trader Joe's,2016-12-15,394993.56,-439.83,food,Ammy Williams,CURRENT
90bfcb64-fc26-4e02-ab2c-5cc94df1023a,bank_d_01.uk,Trader Joe's,2016-12-16,394678.18,-315.38,food,Ammy Williams,CURRENT
06d3f4ce-a5cf-43b0-b56a-8f62e4dde00e,bank_d_01.uk,Registration,2016-12-17,393193.61,-1484.57,education,Ammy Williams,CURRENT
b093e93f-fbea-48d1-acc0-4e0df8fd1339,bank_d_01.uk,Shell,2016-12-18,392095.42,-1098.19,auto,Ammy Williams,CURRENT
cee27753-12e8-4ea0-b0c3-f070837513d7,bank_d_01.uk,Banana Republic,2016-12-23,390971.97,-1123.45,clothing,Ammy Williams,CURRENT
ac022e3c-6c7b-477c-b505-35c2e5072483,bank_d_01.uk,iTunes Music Store,2016-12-27,390158.94,-813.03,entertainment,Ammy Williams,CURRENT
be7b34d7-83f7-407e-b93d-905ad36e926a,bank_d_01.uk,Trader Joe's,2017-01-02,389735.21,-423.73,food,Ammy Williams,CURRENT
86abf282-21c9-4aa4-96f3-9f756fea7c0c,bank_d_01.uk,Dr. Jackson,2017-01-04,388827.04,-908.17,health,Ammy Williams,CURRENT
e2145b37-ca5b-4c46-9390-c2160c600e5c,bank_d_01.uk,Nordstrom,2017-01-06,388364.31,-462.73,gift,Ammy Williams,CURRENT
ece7c84e-932f-4554-a7bd-459895a5671f,bank_d_01.uk,PG&E,2017-01-07,387199.41,-1164.90,utility,Ammy Williams,CURRENT
e7565024-6dda-4e5c-98dc-0c22cfc147f5,bank_d_01.uk,Trader Joe's,2017-01-08,386584.07,-615.34,food,Ammy Williams,CURRENT
5c0fff56-6921-4782-8727-6624579ec852,bank_d_02.uk,INCOME,2017-01-11,282187.65,33000.00,INCOME,Joe Williams,CURRENT
c30aa473-1266-448e-a556-edc583257c75,bank_d_02.uk,Chevron,2017-01-12,280850.23,-1337.42,auto,Joe Williams,CURRENT
c6aa7e80-c0bf-471e-a25b-f39132e2d910,bank_d_02.uk,Safeway,2017-01-13,280158.97,-691.26,food,Joe Williams,CURRENT
7a2ff8b5-bebb-47aa-89d8-5ad6edb1f5fb,bank_d_02.uk,Safeway,2017-01-13,279514.65,-644.32,food,Joe Williams,CURRENT
3f2a4fe5-113a-4b73-8c58-13b060952b03,bank_d_02.uk,Neiman-Marcus,2017-01-16,279222.91,-291.74,gift,Joe Williams,CURRENT
af9258b4-ba82-4d10-9564-cba91a14948d,bank_d_02.uk,Overlimit Fee,2017-01-23,278817.22,-405.69,fee,Joe Williams,CURRENT
2e2f2c82-193c-4a90-bca9-78a039ccd72e,bank_d_02.uk,Safeway,2017-01-25,278159.79,-657.43,food,Joe Williams,CURRENT
01e13784-acf4-4225-9933-a7e7a414696e,bank_d_02.uk,Safeway,2017-01-26,277705.32,-454.47,food,Joe Williams,CURRENT
d6361ff8-052a-4574-bf4f-94d31c24662d,bank_d_02.uk,PG&E,2017-01-28,276407.49,-1297.83,utility,Joe Williams,CURRENT
5cb82746-326b-48bd-a847-1757513bcee0,bank_d_02.uk,Dr. Martins,2017-01-31,274744.06,-1663.43,health,Joe Williams,CURRENT
6a7b27a5-b4c6-4985-86cc-d0555cc49f21,bank_d_02.uk,Metreon Theaters,2017-02-02,273938.98,-805.08,entertainment,Joe Williams,CURRENT
4af455e7-d827-4a3e-8ca0-0cc4b1b21a02,bank_d_02.uk,Registration,2017-02-06,272538.12,-1400.86,education,Joe Williams,CURRENT
7d5fda01-4e20-46ba-9c08-5c6e28f6a4d0,bank_d_02.uk,Safeway,2017-02-07,272128.09,-410.03,food,Joe Williams,CURRENT
dd8928d9-61aa-496c-81f0-42f13cd70f3b,bank_d_02.uk,J. Crew,2017-02-09,270732.65,-1395.44,clothing,Joe Williams,CURRENT
554239bf-8a09-4aef-93fb-de24c2d8e375,bank_d_02.uk,Safeway,2017-02-10,270259.31,-473.34,food,Joe Williams,CURRENT
13e38e10-3ecc-477d-b364-d191f65b270f,bank_d_02.uk,INCOME,2017-01-11,2270000.00,30000.00,INCOME,Joe Williams,SAVING
d584b384-44a4-4c75-9143-8b6f53b0445b,bank_d_00.uk,INCOME,2017-01-11,780000.00,20000.00,INCOME,Ammy Williams,SAVING
cbd2aeb8-682a-4692-b73e-075145caeca2,bank_d_01.uk,INCOME,2017-01-11,446584.07,60000.00,INCOME,Ammy Williams,CURRENT
325170c5-c1c2-4ab5-9696-17f064d33402,bank_d_01.uk,Safeway,2017-01-11,446074.85,-509.22,food,Ammy Williams,CURRENT
38dae666-c00f-4689-a4ba-175e0513fac3,bank_d_01.uk,RENT,2017-01-11,426074.85,-20000.00,RENT,Ammy Williams,CURRENT
521a282d-b9a8-4a22-97af-dd500b161ae1,bank_d_01.uk,Wal-Mart,2017-01-15,425108.55,-966.30,health,Ammy Williams,CURRENT
165a3a17-c166-488a-85af-ca3819352093,bank_d_01.uk,Campus Books,2017-01-16,424011.51,-1097.04,education,Ammy Williams,CURRENT
c21ab4a2-8e0e-40c4-ad9c-20f12f10a8f2,bank_d_01.uk,Nordstrom,2017-01-17,423721.27,-290.24,gift,Ammy Williams,CURRENT
924b6ef2-f8fa-4bf9-bc5e-84c42821ac9a,bank_d_01.uk,,2017-01-22,422333.10,-1388.17,utility,Ammy Williams,CURRENT
3ba25e55-8cfc-4b1e-8a88-77d102a0cb62,bank_d_01.uk,AMC Theaters,2017-01-27,421630.29,-702.81,entertainment,Ammy Williams,CURRENT
7ca9fda8-301e-4614-ab71-10dcb6b15bd8,bank_d_01.uk,Safeway,2017-01-29,420958.49,-671.80,food,Ammy Williams,CURRENT
f3e6330e-53e6-455c-92c8-d9b1ddb3553b,bank_d_01.uk,Safeway,2017-01-29,420506.76,-451.73,food,Ammy Williams,CURRENT
e3fe8f42-1e66-4686-b5ab-bc749c99f802,bank_d_01.uk,Bank Fee,2017-01-29,420142.39,-364.37,fee,Ammy Williams,CURRENT
491d5f18-3f36-4463-a653-f0b12e29d5c2,bank_d_01.uk,Pep Boys,2017-02-05,419035.86,-1106.53,auto,Ammy Williams,CURRENT
9023e203-6348-4a05-975a-fdfb30462eb0,bank_d_01.uk,Nordstrom,2017-02-06,417796.69,-1239.17,clothing,Ammy Williams,CURRENT
557ce0d5-9da7-4808-91c7-c3b9dd6353f7,bank_d_01.uk,Safeway,2017-02-08,417335.09,-461.60,food,Ammy Williams,CURRENT
21c79113-454f-4180-aeec-e1de5a1bb70a,bank_d_01.uk,Safeway,2017-02-09,416822.62,-512.47,food,Ammy Williams,CURRENT
4cdfe7d3-d1d8-478a-b8d7-300477dd3a3e,bank_d_01.uk,Safeway,2017-02-10,416351.19,-471.43,food,Ammy Williams,CURRENT
b208ef0b-3fff-4840-8026-753bff6dab32,bank_d_02.uk,INCOME,2017-02-10,303259.31,33000.00,INCOME,Joe Williams,CURRENT
17d275b9-adc4-48a1-901e-4b65adf28f7a,bank_d_02.uk,Amazon.com,2017-02-10,302801.47,-457.84,entertainment,Joe Williams,CURRENT
698d7bc4-b653-4865-a892-883100d98e6d,bank_d_02.uk,Olive Garden,2017-02-11,302311.43,-490.04,food,Joe Williams,CURRENT
38b1d6f4-0868-4a00-abc6-cbfd7da3a4ca,bank_d_02.uk,Olive Garden,2017-02-12,301880.45,-430.98,food,Joe Williams,CURRENT
898af424-b3eb-4aaa-acbf-0f46adf10e17,bank_d_02.uk,K&L Wines,2017-02-15,301610.27,-270.18,gift,Joe Williams,CURRENT
1c404e24-1fb6-43b9-b2c6-63e06cc84a33,bank_d_02.uk,Walgreen's,2017-02-17,300363.99,-1246.28,health,Joe Williams,CURRENT
95168fbd-a2fd-4bed-aab5-c4ba4052b3e7,bank_d_02.uk,Olive Garden,2017-02-21,299882.75,-481.24,food,Joe Williams,CURRENT
db14e6fe-5e8e-482f-8a99-fc934980c986,bank_d_02.uk,Olive Garden,2017-02-27,299210.72,-672.03,food,Joe Williams,CURRENT
7c91dadf-57ab-4fa7-a179-ed7160e6fc62,bank_d_02.uk,The Gap,2017-02-28,297867.09,-1343.63,clothing,Joe Williams,CURRENT
c5061da8-ae57-47cd-b23e-a1108e9e71c0,bank_d_02.uk,Annual Fee,2017-02-28,297475.08,-392.01,fee,Joe Williams,CURRENT
015bf146-b4bb-46d9-ba68-f6b0ecc35d2b,bank_d_02.uk,Registration,2017-03-01,295797.06,-1678.02,education,Joe Williams,CURRENT
92fa9508-a7ad-416b-be3a-28410aeece9c,bank_d_02.uk,Olive Garden,2017-03-10,295195.84,-601.22,food,Joe Williams,CURRENT
97b4633f-2b41-4b4c-afd9-5e82f354662e,bank_d_02.uk,Arco,2017-03-10,294220.81,-975.03,auto,Joe Williams,CURRENT
059fc539-5731-484f-8b0f-27834c589b99,bank_d_02.uk,INCOME,2017-02-10,2300000.00,30000.00,INCOME,Joe Williams,SAVING
4782c877-9e35-4678-8806-4390e21a7552,bank_d_00.uk,INCOME,2017-02-10,800000.00,20000.00,INCOME,Ammy Williams,SAVING
ab9f5a0c-4952-4569-a5f5-22135432227e,bank_d_01.uk,INCOME,2017-02-10,476351.19,60000.00,INCOME,Ammy Williams,CURRENT
ca221076-2f9f-442a-befd-fda800178105,bank_d_01.uk,RENT,2017-02-10,456351.19,-20000.00,RENT,Ammy Williams,CURRENT
7f26a33e-ce9b-4bf1-9953-bdcb2c069092,bank_d_01.uk,Safeway,2017-02-15,455723.19,-628.00,food,Ammy Williams,CURRENT
b9c0e91a-2590-4df4-9864-11af876e7085,bank_d_01.uk,K&L Wines,2017-02-18,455496.53,-226.66,gift,Ammy Williams,CURRENT
fe4c7c9c-3f24-472f-8ccb-52ce0f75ea43,bank_d_01.uk,Dr. Jackson,2017-02-22,454460.98,-1035.55,health,Ammy Williams,CURRENT
49f7defc-b369-48d4-afbb-e32b93a3e9c5,bank_d_01.uk,Safeway,2017-02-25,453988.97,-472.01,food,Ammy Williams,CURRENT
2f3851b9-be12-46a6-a6f7-c396ca4dc515,bank_d_01.uk,The Gap,2017-02-25,453054.79,-934.18,clothing,Ammy Williams,CURRENT
656a3032-b7c1-4c13-9e19-e27955cdb62d,bank_d_01.uk,Jiffy Lube,2017-02-28,451927.17,-1127.62,auto,Ammy Williams,CURRENT
6a01f166-ed37-4c71-854a-0a2decd30262,bank_d_01.uk,Netflix,2017-02-28,451250.74,-676.43,entertainment,Ammy Williams,CURRENT
71b3dc55-35bf-4ddf-b5d7-fcbd7c031051,bank_d_01.uk,The Crucible,2017-02-28,449592.21,-1658.53,education,Ammy Williams,CURRENT
69f3c3c5-79dc-4536-a1bb-86aa73aaccec,bank_d_01.uk,Safeway,2017-03-03,449266.85,-325.36,food,Ammy Williams,CURRENT
206c62c3-2ba7-4257-b545-e41eaf437447,bank_d_01.uk,Safeway,2017-03-08,448697.22,-569.63,food,Ammy Williams,CURRENT
c22a1cb3-b4b3-4b7c-b804-5a4748f269d8,bank_d_02.uk,INCOME,2017-03-12,327220.81,33000.00,INCOME,Joe Williams,CURRENT
70176041-98ee-47d2-ad64-06e7d383b9bf,bank_d_02.uk,In-N-Out Burger,2017-03-12,326798.11,-422.70,food,Joe Williams,CURRENT
be76ba5a-2c7c-46b7-b028-dbee918a016e,bank_d_02.uk,The Crucible,2017-03-12,325293.40,-1504.71,education,Joe Williams,CURRENT
6fdc2782-481c-4a91-90c5-181ecd410d63,bank_d_02.uk,Metreon Theaters,2017-03-16,324921.56,-371.84,entertainment,Joe Williams,CURRENT
62a3859c-3311-4ad1-9a47-ef134a6e1bd2,bank_d_02.uk,In-N-Out Burger,2017-03-26,324253.71,-667.85,food,Joe Williams,CURRENT
aa454d63-c8ee-450f-888a-f52d5e5d94ce,bank_d_02.uk,Bank Fee,2017-03-27,323687.58,-566.13,fee,Joe Williams,CURRENT
d5d75794-d288-4764-8602-dcc7dbedc971,bank_d_02.uk,Arco,2017-03-28,321963.96,-1723.62,auto,Joe Williams,CURRENT
fae32bc2-0ea2-4c93-84cf-4ef66b0d18c8,bank_d_02.uk,In-N-Out Burger,2017-03-31,321601.56,-362.40,food,Joe Williams,CURRENT
dcfa4826-4b34-42a1-94a3-db31404cfac3,bank_d_02.uk,Dr. Jackson,2017-04-03,319681.48,-1920.08,health,Joe Williams,CURRENT
66a1ba55-6f6e-4952-8cfc-083226e39f5b,bank_d_02.uk,Nordstrom,2017-04-06,318579.78,-1101.70,clothing,Joe Williams,CURRENT
cff3b1ed-fff6-4787-963a-62fdff1af110,bank_d_02.uk,Comcast,2017-04-07,317085.12,-1494.66,utility,Joe Williams,CURRENT
d4234587-2510-459c-9cf9-7858a0eeafe9,bank_d_02.uk,In-N-Out Burger,2017-04-10,316537.83,-547.29,food,Joe Williams,CURRENT
5e10452a-5c8b-4046-950f-bab9dcf8fb9f,bank_d_02.uk,In-N-Out Burger,2017-04-11,316227.44,-310.39,food,Joe Williams,CURRENT
e0745d19-c8f8-4252-8038-6db2b931c0a5,bank_d_02.uk,INCOME,2017-03-12,2330000.00,30000.00,INCOME,Joe Williams,SAVING
bef72984-4e45-4a9d-93f9-536e2084c6c8,bank_d_00.uk,INCOME,2017-03-12,820000.00,20000.00,INCOME,Ammy Williams,SAVING
d1df3d29-deeb-459f-be6c-2c9afec7309f,bank_d_01.uk,INCOME,2017-03-12,508697.22,60000.00,INCOME,Ammy Williams,CURRENT
176f8898-bbfe-4267-91aa-0896cb4e33ba,bank_d_01.uk,RENT,2017-03-12,488697.22,-20000.00,RENT,Ammy Williams,CURRENT
41d359aa-38d1-4b58-8fa8-dc7c0d8d8d0a,bank_d_01.uk,Dr. Jackson,2017-03-13,487385.98,-1311.24,health,Ammy Williams,CURRENT
db01b72e-0f62-4500-9519-359fe7fe60d8,bank_d_01.uk,J. Crew,2017-03-17,485966.83,-1419.15,clothing,Ammy Williams,CURRENT
9392a31b-10ca-4666-87bb-757ac68df405,bank_d_01.uk,Starbucks,2017-03-18,485290.91,-675.92,food,Ammy Williams,CURRENT
f7547c87-63f3-4715-aafd-a28711df89f9,bank_d_01.uk,Starbucks,2017-03-19,484659.01,-631.90,food,Ammy Williams,CURRENT
20347573-9623-42f6-9e3c-c8c3ea357c69,bank_d_01.uk,Starbucks,2017-03-21,483948.96,-710.05,food,Ammy Williams,CURRENT
8ef302b2-556d-44ae-a66b-462d283ea3c9,bank_d_01.uk,Brinks,2017-03-21,482593.69,-1355.27,utility,Ammy Williams,CURRENT
62febd2f-7c46-4251-b219-bacbaf2a08ab,bank_d_01.uk,iTunes Music Store,2017-03-23,482040.49,-553.20,entertainment,Ammy Williams,CURRENT
62ec86d9-1864-45ce-97de-b7fe52378c53,bank_d_01.uk,Campus Books,2017-03-24,481104.91,-935.58,education,Ammy Williams,CURRENT
83a8c5c7-3bca-4c71-aaca-a33961c5afa4,bank_d_01.uk,Arco,2017-03-26,479854.02,-1250.89,auto,Ammy Williams,CURRENT
76be385f-6adb-4c9d-ae62-113052274ca0,bank_d_01.uk,Starbucks,2017-04-06,479398.12,-455.90,food,Ammy Williams,CURRENT
c6697363-f990-4017-b472-2e38e4e3984e,bank_d_01.uk,Neiman-Marcus,2017-04-07,479130.32,-267.80,gift,Ammy Williams,CURRENT
895502d7-7186-4ce1-92b6-911d167bbbe0,bank_d_01.uk,Bank Fee,2017-04-10,478607.21,-523.11,fee,Ammy Williams,CURRENT
eaf2195f-4b59-4ebd-84db-dda140905b4f,bank_d_02.uk,INCOME,2017-04-11,349227.44,33000.00,INCOME,Joe Williams,CURRENT
cc0d90ac-84c0-4e9d-86af-6d27764e0850,bank_d_02.uk,The Gap,2017-04-11,348186.84,-1040.60,clothing,Joe Williams,CURRENT
589ee9b9-7dd3-433d-92e7-4bb5c607544f,bank_d_02.uk,Trader Joe's,2017-04-15,347623.76,-563.08,food,Joe Williams,CURRENT
cdf188c6-11df-4b94-9914-78b5a95f20b9,bank_d_02.uk,iTunes Music Store,2017-04-21,346990.69,-633.07,entertainment,Joe Williams,CURRENT
f1c47f8f-8fbf-4041-a131-fa9a556d06e0,bank_d_02.uk,Interest Fee,2017-04-23,346653.14,-337.55,fee,Joe Williams,CURRENT
c02e45f7-bf19-42d8-bd6c-f54f15dab4ce,bank_d_02.uk,Trader Joe's,2017-04-25,346271.79,-381.35,food,Joe Williams,CURRENT
85e165ff-8a5a-43d5-a744-2e4431b450a7,bank_d_02.uk,The Crucible,2017-04-26,345475.13,-796.66,education,Joe Williams,CURRENT
eb65349e-9e0e-4e4a-9eb7-00a7c3899ed9,bank_d_02.uk,Nordstrom,2017-04-29,345142.84,-332.29,gift,Joe Williams,CURRENT
34fbe1f8-57ba-47fe-b896-f066eb66c233,bank_d_02.uk,Trader Joe's,2017-05-02,344737.12,-405.72,food,Joe Williams,CURRENT
6bc8e087-621d-40e0-9620-67c1c9a388cc,bank_d_02.uk,Trader Joe's,2017-05-02,344218.83,-518.29,food,Joe Williams,CURRENT
efb6bdd4-8e8c-4578-a93a-ea8efd241cd0,bank_d_02.uk,Dr. Martins,2017-05-02,342977.77,-1241.06,health,Joe Williams,CURRENT
b6b74b6c-f6a4-4aba-9af2-981030f6ab92,bank_d_02.uk,Brinks,2017-05-05,341082.47,-1895.30,utility,Joe Williams,CURRENT
9be96b25-6f4c-476f-8559-caa61700c20b,bank_d_02.uk,Trader Joe's,2017-05-07,340428.11,-654.36,food,Joe Williams,CURRENT
43a56806-a59e-406b-b956-57e27802587a,bank_d_02.uk,Trader Joe's,2017-05-09,339964.97,-463.14,food,Joe Williams,CURRENT
22ccf76f-b67c-4895-868b-75b9a6e2361b,bank_d_02.uk,INCOME,2017-04-11,2360000.00,30000.00,INCOME,Joe Williams,SAVING
959e2588-80b8-484d-9b83-e7e68e3fdde4,bank_d_00.uk,INCOME,2017-04-11,840000.00,20000.00,INCOME,Ammy Williams,SAVING
9ca5f4c3-b313-4b0c-88ca-49c70e3b47b1,bank_d_01.uk,INCOME,2017-04-11,538607.21,60000.00,INCOME,Ammy Williams,CURRENT
73cc892f-5d6b-48b4-8c2e-72d2ad517824,bank_d_01.uk,Nordstrom,2017-04-11,538222.03,-385.18,gift,Ammy Williams,CURRENT
43a72319-49c3-4ed5-ad46-0287464dc90c,bank_d_01.uk,RENT,2017-04-11,518222.03,-20000.00,RENT,Ammy Williams,CURRENT
fc03ba75-b70f-411a-87bd-a5d80f033b8e,bank_d_01.uk,Whole Foods,2017-04-13,517803.04,-418.99,food,Ammy Williams,CURRENT
9c7ca597-a7f1-451c-8899-f70a43d00b63,bank_d_01.uk,Netflix,2017-04-20,517040.13,-762.91,entertainment,Ammy Williams,CURRENT
3d1037eb-8aaf-4590-a0e3-3879b643f05e,bank_d_01.uk,Whole Foods,2017-04-23,516570.61,-469.52,food,Ammy Williams,CURRENT
1d166fdd-2d2f-4655-8652-eb6f0739efb9,bank_d_01.uk,Whole Foods,2017-04-24,515916.85,-653.76,food,Ammy Williams,CURRENT
953e97d9-4315-4ba5-9651-986ff525f155,bank_d_01.uk,Walgreen's,2017-04-24,514200.68,-1716.17,health,Ammy Williams,CURRENT
5d8c9b0a-f98c-4bc9-8394-c7ac781ae21b,bank_d_01.uk,Bank Fee,2017-04-24,513738.18,-462.50,fee,Ammy Williams,CURRENT
4bc8f20e-77b6-4f99-9e76-bb639a7d9488,bank_d_01.uk,Brinks,2017-04-27,512162.40,-1575.78,utility,Ammy Williams,CURRENT
9f4b9f79-1dbe-4c5f-8df2-81ae7d8f1eec,bank_d_01.uk,Registration,2017-04-29,510671.15,-1491.25,education,Ammy Williams,CURRENT
a1767c0b-a7da-4918-a79a-3f1e85c7dbea,bank_d_01.uk,Whole Foods,2017-05-01,510085.71,-585.44,food,Ammy Williams,CURRENT
66e9f3b4-e007-4e1d-9332-9314bd0d74d5,bank_d_01.uk,Banana Republic,2017-05-02,508733.49,-1352.22,clothing,Ammy Williams,CURRENT
58c0130e-d80e-44cc-8306-a31126cfc276,bank_d_01.uk,Whole Foods,2017-05-04,508199.49,-534.00,food,Ammy Williams,CURRENT
8a1dacdd-7e09-47a8-8e53-fd348df361f8,bank_d_01.uk,Chevron,2017-05-04,506789.70,-1409.79,auto,Ammy Williams,CURRENT
4a9c8aa3-367b-4d74-bb75-bbe2fbeb61b6,bank_d_02.uk,INCOME,2017-05-11,372964.97,33000.00,INCOME,Joe Williams,CURRENT
5ed29380-c0d1-469e-8015-7b5cbb78e041,bank_d_02.uk,PG&E,2017-05-12,371687.65,-1277.32,utility,Joe Williams,CURRENT
a7d7fadd-b7ce-4eee-b799-2b825c2c7a26,bank_d_02.uk,Olive Garden,2017-05-14,371073.38,-614.27,food,Joe Williams,CURRENT
666ca983-2013-48cc-956b-adbdfe7b2135,bank_d_02.uk,Dr. Roberts,2017-05-16,369620.31,-1453.07,health,Joe Williams,CURRENT
5b6619c8-29a5-4a8d-add7-7d554bb6d93a,bank_d_02.uk,K&L Wines,2017-05-17,369160.37,-459.94,gift,Joe Williams,CURRENT
c6ee4401-93dc-4bb7-bd51-f7f57551ab88,bank_d_02.uk,Olive Garden,2017-05-29,368727.71,-432.66,food,Joe Williams,CURRENT
59ba6263-a294-4c37-8735-571940c0a776,bank_d_02.uk,Jiffy Lube,2017-05-29,367306.54,-1421.17,auto,Joe Williams,CURRENT
d9cf977f-4243-4650-990b-42cf3e18c288,bank_d_02.uk,Olive Garden,2017-05-30,366613.85,-692.69,food,Joe Williams,CURRENT
b14946fe-581e-4e29-b5f8-5c441e3624f7,bank_d_02.uk,iTunes Music Store,2017-06-02,366044.69,-569.16,entertainment,Joe Williams,CURRENT
db86a1f6-debc-471e-81c7-395f75ed79b3,bank_d_02.uk,The Gap,2017-06-06,365079.16,-965.53,clothing,Joe Williams,CURRENT
d6cdecca-1744-4e36-932c-5ba9aeb64bb3,bank_d_02.uk,Olive Garden,2017-06-08,364477.12,-602.04,food,Joe Williams,CURRENT
4846ded0-9fda-430d-9313-d8fee0356764,bank_d_02.uk,INCOME,2017-05-11,2390000.00,30000.00,INCOME,Joe Williams,SAVING
4bc57af3-755a-4b6c-b1e1-66cd1c21fd47,bank_d_00.uk,INCOME,2017-05-11,860000.00,20000.00,INCOME,Ammy Williams,SAVING
460c36c5-79a1-42b8-9904-26d633f98883,bank_d_01.uk,INCOME,2017-05-11,566789.70,60000.00,INCOME,Ammy Williams,CURRENT
db43398d-3d92-47ed-993c-89ff1dc700cc,bank_d_01.uk,RENT,2017-05-11,546789.70,-20000.00,RENT,Ammy Williams,CURRENT
c820ffc1-fccc-4e31-8c68-bea1838251a3,bank_d_01.uk,Dr. Roberts,2017-05-17,545835.84,-953.86,health,Ammy Williams,CURRENT
12f2defe-52cb-44e6-af96-ead393b345ab,bank_d_01.uk,Trader Joe's,2017-05-21,545484.01,-351.83,food,Ammy Williams,CURRENT
18aa48e8-e701-4cdb-a785-ff55dd5a14ea,bank_d_01.uk,The Crucible,2017-05-22,543925.71,-1558.30,education,Ammy Williams,CURRENT
dc6116b9-e279-419c-91ba-50ce622c63a8,bank_d_01.uk,Trader Joe's,2017-05-23,543536.48,-389.23,food,Ammy Williams,CURRENT
e10a6bcb-a856-4d3d-9cd6-fceb05ce8809,bank_d_01.uk,Neiman-Marcus,2017-05-23,543199.52,-336.96,gift,Ammy Williams,CURRENT
afadc24a-8d21-4b8b-bb19-84796ddd2039,bank_d_01.uk,Trader Joe's,2017-05-26,542619.07,-580.45,food,Ammy Williams,CURRENT
03864df9-fa96-4d41-ac9e-37965462f1bb,bank_d_01.uk,Verizon,2017-05-31,540355.72,-2263.35,utility,Ammy Williams,CURRENT
f89c68ad-2f31-466f-80fe-5557cb808a00,bank_d_01.uk,Kenneth Cole,2017-06-01,539463.77,-891.95,clothing,Ammy Williams,CURRENT
bf711048-bf2e-498e-bb69-d1f85ae3c6a3,bank_d_01.uk,Trader Joe's,2017-06-04,538805.83,-657.94,food,Ammy Williams,CURRENT
54f99b61-ef64-4a93-a4fe-d2adb7d4c346,bank_d_01.uk,Trader Joe's,2017-06-07,538114.76,-691.07,food,Ammy Williams,CURRENT
de002967-389b-478e-b725-5152c81b24d9,bank_d_01.uk,Amazon.com,2017-06-07,537319.80,-794.96,entertainment,Ammy Williams,CURRENT
af8bc2ca-b835-4623-9e50-6d945577cacd,bank_d_01.uk,Trader Joe's,2017-06-10,536909.78,-410.02,food,Ammy Williams,CURRENT
a25f150b-b8c0-4109-8ee5-214ea85efa3f,bank_d_02.uk,INCOME,2017-06-10,397477.12,33000.00,INCOME,Joe Williams,CURRENT
af23b52b-7a2e-4b60-a07d-11541df97808,bank_d_02.uk,Wal-Mart,2017-06-10,395739.08,-1738.04,health,Joe Williams,CURRENT
4f1f2787-cd7c-4c51-bbe2-a83c6e5d3911,bank_d_02.uk,Whole Foods,2017-06-12,395031.06,-708.02,food,Joe Williams,CURRENT
805a3b45-82da-4b4b-a6b6-ede535b6c2ce,bank_d_02.uk,Comcast,2017-06-13,393395.66,-1635.40,utility,Joe Williams,CURRENT
4cc2269c-2cc8-4d01-b4ec-95da7a4b5e52,bank_d_02.uk,AMC Theaters,2017-06-26,392972.01,-423.65,entertainment,Joe Williams,CURRENT
0a6877d2-f749-4e21-b16f-6009f3dab6bb,bank_d_02.uk,Whole Foods,2017-06-27,392334.48,-637.53,food,Joe Williams,CURRENT
04536878-fc9e-4449-adb1-6f0c0044b493,bank_d_02.uk,Whole Foods,2017-06-28,391643.99,-690.49,food,Joe Williams,CURRENT
55dec5f3-594b-4ac2-9740-1b9f2a6595fc,bank_d_02.uk,Apple Store,2017-06-30,391319.12,-324.87,gift,Joe Williams,CURRENT
14825857-85ce-4082-8169-c6853033c9c1,bank_d_02.uk,Whole Foods,2017-07-01,390653.48,-665.64,food,Joe Williams,CURRENT
04e180c5-9dd8-441d-924b-66316675116f,bank_d_02.uk,Whole Foods,2017-07-06,390265.00,-388.48,food,Joe Williams,CURRENT
2664cde5-f016-47f7-a1e9-b268f3e25f08,bank_d_02.uk,Whole Foods,2017-07-06,389865.20,-399.80,food,Joe Williams,CURRENT
50795c1c-e72f-4781-b482-cdd3e31f23cc,bank_d_02.uk,The Crucible,2017-07-06,388330.78,-1534.42,education,Joe Williams,CURRENT
89c53475-a77e-4fe4-9d1e-ef7a38f70382,bank_d_02.uk,Monthly Fee,2017-07-08,387943.77,-387.01,fee,Joe Williams,CURRENT
dcca9752-b104-4da1-ba1f-0c5a5018cedb,bank_d_02.uk,The Gap,2017-07-09,387169.70,-774.07,clothing,Joe Williams,CURRENT
d17b1470-ad5d-45dd-a581-aa35f069d53b,bank_d_02.uk,INCOME,2017-06-10,2420000.00,30000.00,INCOME,Joe Williams,SAVING
b8c1b59f-3d86-4f64-82b2-fa981971ec09,bank_d_00.uk,INCOME,2017-06-10,880000.00,20000.00,INCOME,Ammy Williams,SAVING
bf6844b4-a9c0-4cf0-9b8e-a1cbc9c40563,bank_d_01.uk,INCOME,2017-06-10,596909.78,60000.00,INCOME,Ammy Williams,CURRENT
a6a01ff2-ed91-4533-9db9-3a41c04fc1e9,bank_d_01.uk,RENT,2017-06-10,576909.78,-20000.00,RENT,Ammy Williams,CURRENT
758d9577-78a3-475b-8e58-5a80d863dd95,bank_d_01.uk,Dr. Martins,2017-06-12,575012.18,-1897.60,health,Ammy Williams,CURRENT
2e34d754-fa56-4a62-9807-17537e88d9be,bank_d_01.uk,Rhapsody,2017-06-12,574421.96,-590.22,entertainment,Ammy Williams,CURRENT
ada74a04-521b-4596-96b0-a822bd33531f,bank_d_01.uk,Amazon.com,2017-06-16,574167.47,-254.49,gift,Ammy Williams,CURRENT
5f2d7be3-d40d-494a-a5f6-48ce8b481e4b,bank_d_01.uk,Whole Foods,2017-06-17,573799.50,-367.97,food,Ammy Williams,CURRENT
0ce332ab-613f-4ce7-a8b3-375318e517ba,bank_d_01.uk,Kenneth Cole,2017-06-17,573089.20,-710.30,clothing,Ammy Williams,CURRENT
adc82299-2d6d-4681-8b81-b64dcb955c8d,bank_d_01.uk,Whole Foods,2017-06-23,572648.69,-440.51,food,Ammy Williams,CURRENT
a28160fc-5053-4367-8b1f-be595aea9312,bank_d_01.uk,Whole Foods,2017-06-30,572079.60,-569.09,food,Ammy Williams,CURRENT
3244649b-ad05-4353-a66a-6c659cc73fae,bank_d_01.uk,Whole Foods,2017-07-04,571403.05,-676.55,food,Ammy Williams,CURRENT
87b713df-30fb-4271-830a-ab52897cefd3,bank_d_01.uk,PG&E,2017-07-04,569031.45,-2371.60,utility,Ammy Williams,CURRENT
a527db9d-792c-4724-a5b8-ae42e2d39971,bank_d_01.uk,Whole Foods,2017-07-06,568367.81,-663.64,food,Ammy Williams,CURRENT
010901cc-4315-41a8-8f5b-6b1ab94ccc31,bank_d_01.uk,Campus Books,2017-07-07,567467.87,-899.94,education,Ammy Williams,CURRENT
f56bc6a6-be47-4987-94eb-74d2cbbf1ef0,bank_d_01.uk,Whole Foods,2017-07-09,566955.04,-512.83,food,Ammy Williams,CURRENT
1388aec4-4341-44d0-81b2-2ac29cc68c5c,bank_d_01.uk,Annual Fee,2017-07-10,566632.25,-322.79,fee,Ammy Williams,CURRENT
eb7f15c0-e440-43af-862e-0e258c4469ca,bank_d_02.uk,INCOME,2017-07-10,420169.70,33000.00,INCOME,Joe Williams,CURRENT
30a5bb9c-e2da-46c3-be69-489b8224376b,bank_d_02.uk,Safeway,2017-07-12,419495.37,-674.33,food,Joe Williams,CURRENT
01ac0afd-2359-43f6-98e3-eb35476556ba,bank_d_02.uk,K&L Wines,2017-07-19,419120.45,-374.92,gift,Joe Williams,CURRENT
b8bb2ab5-bf03-4603-9532-d8e4f53a89c6,bank_d_02.uk,Tuition,2017-07-21,418080.22,-1040.23,education,Joe Williams,CURRENT
56bc22a3-bd41-4395-81a8-3dfe303d3747,bank_d_02.uk,Dr. Martins,2017-07-28,416246.03,-1834.19,health,Joe Williams,CURRENT
91746e75-9422-4a07-8f6e-a6705f4fcaab,bank_d_02.uk,The Gap,2017-07-29,415074.14,-1171.89,clothing,Joe Williams,CURRENT
1e34a365-d688-4491-967a-913032a515fb,bank_d_02.uk,Shell,2017-07-30,413408.44,-1665.70,auto,Joe Williams,CURRENT
e4f143bd-dc03-4d87-9f24-ed2372d6c05c,bank_d_02.uk,Safeway,2017-07-31,412704.67,-703.77,food,Joe Williams,CURRENT
d24a37a8-f978-42fc-aeca-35665de23b8b,bank_d_02.uk,Rhapsody,2017-08-01,412083.42,-621.25,entertainment,Joe Williams,CURRENT
2e0faf82-e01e-40d8-a0a0-5a910f735aa4,bank_d_02.uk,Safeway,2017-08-08,411635.24,-448.18,food,Joe Williams,CURRENT
39360565-5cc7-46fd-8026-b86a783a980a,bank_d_02.uk,Safeway,2017-08-09,411105.57,-529.67,food,Joe Williams,CURRENT
50762090-e922-4ab2-bcd0-a4205b888a55,bank_d_02.uk,INCOME,2017-07-10,2450000.00,30000.00,INCOME,Joe Williams,SAVING
fc053049-87ec-429a-9aef-1d6dffa3cc49,bank_d_00.uk,INCOME,2017-07-10,900000.00,20000.00,INCOME,Ammy Williams,SAVING
7007cce1-41c7-4458-9ddc-9d1d76a0bd53,bank_d_01.uk,INCOME,2017-07-10,626632.25,60000.00,INCOME,Ammy Williams,CURRENT
f1d0409f-ecf6-4249-b2aa-21ff8a39954b,bank_d_01.uk,RENT,2017-07-10,606632.25,-20000.00,RENT,Ammy Williams,CURRENT
8d9db185-204b-4fea-a66c-afa30f80bd5e,bank_d_01.uk,Trader Joe's,2017-07-11,606127.06,-505.19,food,Ammy Williams,CURRENT
53f799de-274d-4810-9150-ed8a863edfde,bank_d_01.uk,Annual Fee,2017-07-11,605738.41,-388.65,fee,Ammy Williams,CURRENT
152a4ce0-d6e5-435b-9d14-6d7f95cc68b5,bank_d_01.uk,Dr. Jackson,2017-07-13,604095.56,-1642.85,health,Ammy Williams,CURRENT
3a2bc24e-1186-4e29-acf0-39ad7a628089,bank_d_01.uk,Trader Joe's,2017-07-14,603424.95,-670.61,food,Ammy Williams,CURRENT
751cc9c3-3570-48b0-8da0-d477d2751f5e,bank_d_01.uk,Registration,2017-07-17,601798.15,-1626.80,education,Ammy Williams,CURRENT
167ad447-7cf8-41a0-a9fc-9666ca78973f,bank_d_01.uk,Trader Joe's,2017-07-25,601223.25,-574.90,food,Ammy Williams,CURRENT
a944b253-1ed3-4197-999d-b3f918e20492,bank_d_01.uk,,2017-07-27,599810.69,-1412.56,utility,Ammy Williams,CURRENT
47e089f5-858c-4eb8-be57-c245b489fb2b,bank_d_01.uk,Macy's,2017-07-27,598402.22,-1408.47,clothing,Ammy Williams,CURRENT
760bf2e8-4abd-4a93-80e6-e0aa6595b74c,bank_d_01.uk,Trader Joe's,2017-07-30,597757.70,-644.52,food,Ammy Williams,CURRENT
6b71ff11-0c0a-49d6-990d-c761fffd51f7,bank_d_01.uk,Trader Joe's,2017-08-01,597074.79,-682.91,food,Ammy Williams,CURRENT
629c88e2-f551-4a11-bfc5-1cc23c037895,bank_d_01.uk,Shell,2017-08-01,596040.14,-1034.65,auto,Ammy Williams,CURRENT
fc66d11d-7530-442a-858a-21aabfc2df3c,bank_d_01.uk,Metreon Theaters,2017-08-05,595612.58,-427.56,entertainment,Ammy Williams,CURRENT
c02c1a3f-7934-40ff-bbd3-895d36910240,bank_d_02.uk,INCOME,2017-08-09,444105.57,33000.00,INCOME,Joe Williams,CURRENT
61af5a53-c8f2-402e-aeb4-dc1908c8de78,bank_d_02.uk,Amazon.com,2017-08-09,443312.38,-793.19,entertainment,Joe Williams,CURRENT
ec93d346-867c-4729-801e-39779f9d000b,bank_d_02.uk,Kenneth Cole,2017-08-17,442249.50,-1062.88,clothing,Joe Williams,CURRENT
16ac0852-9a90-45ba-b54b-eba68b400683,bank_d_02.uk,Dr. Jackson,2017-08-21,441267.38,-982.12,health,Joe Williams,CURRENT
ee35e63b-2696-47c7-afce-e0fd3c304bcf,bank_d_02.uk,AT&T,2017-08-22,439234.06,-2033.32,utility,Joe Williams,CURRENT
67c02d48-1958-4911-8a39-6484d5dc98ab,bank_d_02.uk,In-N-Out Burger,2017-08-24,438587.53,-646.53,food,Joe Williams,CURRENT
977e2bef-1465-43d2-b25a-136d0ff7fa2d,bank_d_02.uk,Union 76,2017-08-26,437074.02,-1513.51,auto,Joe Williams,CURRENT
07ace895-53d3-4370-89a0-9f32848452fe,bank_d_02.uk,Bank Fee,2017-08-26,436566.78,-507.24,fee,Joe Williams,CURRENT
e621bb35-2e15-42eb-8569-ef0a0f107023,bank_d_02.uk,In-N-Out Burger,2017-08-28,436197.16,-369.62,food,Joe Williams,CURRENT
26aaae34-69af-4404-9e65-645a89c979e0,bank_d_02.uk,In-N-Out Burger,2017-08-28,435522.72,-674.44,food,Joe Williams,CURRENT
54ef5055-4df3-4349-8817-b9cd927de807,bank_d_02.uk,Campus Books,2017-08-30,434716.12,-806.60,education,Joe Williams,CURRENT
cb7791c4-f869-4999-9ae4-de549caa3768,bank_d_02.uk,In-N-Out Burger,2017-09-01,434289.15,-426.97,food,Joe Williams,CURRENT
c8a9ea09-2d4b-4f52-927e-0080eded8111,bank_d_02.uk,In-N-Out Burger,2017-09-02,433782.48,-506.67,food,Joe Williams,CURRENT
8dc6ec06-9bce-4e85-a0d6-6ad35c002b32,bank_d_02.uk,Nordstrom,2017-09-07,433307.34,-475.14,gift,Joe Williams,CURRENT
74a20913-44fa-440b-a130-1d9b8b9bbbd7,bank_d_02.uk,INCOME,2017-08-09,2480000.00,30000.00,INCOME,Joe Williams,SAVING
65a02ab9-da2d-4542-a812-086b9a7c432d,bank_d_00.uk,INCOME,2017-08-09,920000.00,20000.00,INCOME,Ammy Williams,SAVING
8decfc85-660d-408f-90c2-bcff87934828,bank_d_01.uk,INCOME,2017-08-09,655612.58,60000.00,INCOME,Ammy Williams,CURRENT
ae2efcac-ec01-4d8e-96ce-5bf0bd8a862a,bank_d_01.uk,RENT,2017-08-09,635612.58,-20000.00,RENT,Ammy Williams,CURRENT
e9754916-c382-47af-b0b8-0420b522615b,bank_d_01.uk,Wal-Mart,2017-08-10,634324.65,-1287.93,health,Ammy Williams,CURRENT
567d5a6c-b27e-4126-801f-bd0b6c3f244f,bank_d_01.uk,Trader Joe's,2017-08-11,633959.65,-365.00,food,Ammy Williams,CURRENT
1b527adc-0cfd-4ddf-9f57-4759dc0fb30e,bank_d_01.uk,Trader Joe's,2017-08-12,633335.24,-624.41,food,Ammy Williams,CURRENT
8fe156a6-9449-4d03-a2c3-82629ba3a1cc,bank_d_01.uk,Shell,2017-08-19,631934.98,-1400.26,auto,Ammy Williams,CURRENT
c6da2baf-8eb1-45fe-b582-33d9a8fe8357,bank_d_01.uk,The Crucible,2017-08-19,631112.35,-822.63,education,Ammy Williams,CURRENT
fac989e8-ec66-4c71-9d26-b69429b7cb48,bank_d_01.uk,Trader Joe's,2017-08-21,630508.73,-603.62,food,Ammy Williams,CURRENT
21ea7f16-5188-4edb-93e7-3fb0084cf440,bank_d_01.uk,Trader Joe's,2017-08-29,630048.92,-459.81,food,Ammy Williams,CURRENT
4d7c1a10-e788-4c21-8374-f8f904f15780,bank_d_01.uk,Trader Joe's,2017-08-29,629620.45,-428.47,food,Ammy Williams,CURRENT
aa8977b4-362f-42f5-85a0-d30d33da4fc6,bank_d_01.uk,Brinks,2017-09-01,627572.98,-2047.47,utility,Ammy Williams,CURRENT
203c59db-5c6e-41e9-8568-50a383dbe3fd,bank_d_01.uk,Kenneth Cole,2017-09-03,626494.08,-1078.90,clothing,Ammy Williams,CURRENT
9d391314-e6c1-4229-8bc5-e7c7604730aa,bank_d_01.uk,Trader Joe's,2017-09-04,625815.39,-678.69,food,Ammy Williams,CURRENT
b99a4d44-2c0c-4cef-9b76-b4e55aab6d01,bank_d_01.uk,Amazon.com,2017-09-06,625423.29,-392.10,entertainment,Ammy Williams,CURRENT
92b2ac63-2012-4b2f-bdfb-50bc91a0b42e,bank_d_01.uk,Amazon.com,2017-09-08,625037.30,-385.99,gift,Ammy Williams,CURRENT
0a2c5231-88d5-400b-a30b-9e7ae2c3c16f,bank_d_02.uk,INCOME,2017-09-08,466307.34,33000.00,INCOME,Joe Williams,CURRENT
ec31962b-aee0-42c7-ba90-00471fd68446,bank_d_02.uk,Arco,2017-09-10,464972.90,-1334.44,auto,Joe Williams,CURRENT
4fa97a79-a551-4654-a627-82266b6b81f6,bank_d_02.uk,Netflix,2017-09-10,464595.26,-377.64,entertainment,Joe Williams,CURRENT
99d89c4d-4e96-41a2-9f14-71784de47fb4,bank_d_02.uk,Brinks,2017-09-13,463437.41,-1157.85,utility,Joe Williams,CURRENT
52bc9772-105d-4b95-bff1-697e944f4e9a,bank_d_02.uk,Whole Foods,2017-09-15,463088.00,-349.41,food,Joe Williams,CURRENT
e9307e2a-bd7c-46ef-bc2c-b9ec9da2521f,bank_d_02.uk,Whole Foods,2017-09-16,462677.03,-410.97,food,Joe Williams,CURRENT
2decaa73-ecf6-49f0-9544-e4ac10898ad7,bank_d_02.uk,Banana Republic,2017-09-16,461823.03,-854.00,clothing,Joe Williams,CURRENT
eb8abc2e-23e4-45a8-a989-8cf980fd55fe,bank_d_02.uk,Whole Foods,2017-09-18,461342.16,-480.87,food,Joe Williams,CURRENT
b515fd64-64df-4844-9a19-0e2d57d7ded2,bank_d_02.uk,Campus Books,2017-09-21,460428.95,-913.21,education,Joe Williams,CURRENT
767e2753-2780-4227-94ed-cbd44d7fb984,bank_d_02.uk,Whole Foods,2017-09-25,459882.81,-546.14,food,Joe Williams,CURRENT
ea22dca5-b2be-4d67-a5d9-ac92c0317866,bank_d_02.uk,Wal-Mart,2017-09-27,458206.72,-1676.09,health,Joe Williams,CURRENT
202fdb2b-1ce9-43b4-8599-f9f8e557c188,bank_d_02.uk,Whole Foods,2017-09-29,457830.21,-376.51,food,Joe Williams,CURRENT
2bdb4ed4-aad7-4ec4-b1d1-5d7ce416d17d,bank_d_02.uk,Nordstrom,2017-10-01,457509.82,-320.39,gift,Joe Williams,CURRENT
d8e5102c-95d9-419b-8668-8e971aaeba2c,bank_d_02.uk,INCOME,2017-09-08,2510000.00,30000.00,INCOME,Joe Williams,SAVING
ae687540-8805-49cb-a496-149ad86e0b46,bank_d_00.uk,INCOME,2017-09-08,940000.00,20000.00,INCOME,Ammy Williams,SAVING
d8856dfd-e1f2-420c-ae5d-656d874b85ea,bank_d_01.uk,INCOME,2017-09-08,685037.30,60000.00,INCOME,Ammy Williams,CURRENT
50c608e0-4f8c-4959-83eb-deb7d92efbdf,bank_d_01.uk,RENT,2017-09-08,665037.30,-20000.00,RENT,Ammy Williams,CURRENT
ca24e09a-0bf4-46ec-89f9-1264b9b243a6,bank_d_01.uk,Nordstrom,2017-09-13,663792.71,-1244.59,clothing,Ammy Williams,CURRENT
8e1bbef2-27f7-4320-b92f-16db305b79b7,bank_d_01.uk,iTunes Music Store,2017-09-13,663122.96,-669.75,entertainment,Ammy Williams,CURRENT
c47ac0e9-459a-481f-888c-bb3be1f90c51,bank_d_01.uk,Olive Garden,2017-09-20,662724.17,-398.79,food,Ammy Williams,CURRENT
f59aa55d-7855-423e-b30c-5ebd520b3543,bank_d_01.uk,Olive Garden,2017-09-21,662201.40,-522.77,food,Ammy Williams,CURRENT
53a8e4ed-09d4-4d06-87b6-7a6f2726694c,bank_d_01.uk,Bank Fee,2017-09-21,661696.36,-505.04,fee,Ammy Williams,CURRENT
026a4280-4c52-427a-bd25-70dea2a78ad4,bank_d_01.uk,PG&E,2017-09-23,660313.85,-1382.51,utility,Ammy Williams,CURRENT
af848f07-ad20-481f-a613-84a4cf026383,bank_d_01.uk,Olive Garden,2017-09-27,659666.05,-647.80,food,Ammy Williams,CURRENT
5923b2a4-3f43-4b03-a1a4-c4f9407d8a59,bank_d_01.uk,Olive Garden,2017-09-30,659297.77,-368.28,food,Ammy Williams,CURRENT
5600ffda-6d12-43fb-a96a-2d0f7cf4479b,bank_d_01.uk,Registration,2017-10-05,658448.14,-849.63,education,Ammy Williams,CURRENT
fdb984f4-660a-49ff-b3f1-eeb0622d4437,bank_d_01.uk,Chevron,2017-10-07,657374.51,-1073.63,auto,Ammy Williams,CURRENT
45acb4c6-0688-4277-bc05-7b5fe7034623,bank_d_01.uk,Dr. Phillips,2017-10-07,656398.53,-975.98,health,Ammy Williams,CURRENT
7efe5811-086d-408d-96b6-2c8430a0e7ec,bank_d_02.uk,INCOME,2017-10-08,490509.82,33000.00,INCOME,Joe Williams,CURRENT
0c15d8bd-daed-4ef7-b665-f2ec23001c65,bank_d_02.uk,Amazon.com,2017-10-09,489988.84,-520.98,entertainment,Joe Williams,CURRENT
9bda61df-a477-4873-be60-d392bbd4bbad,bank_d_02.uk,Trader Joe's,2017-10-10,489368.00,-620.84,food,Joe Williams,CURRENT
dbe8f567-14bb-46db-9b2c-7e129fcae98a,bank_d_02.uk,Trader Joe's,2017-10-12,488768.18,-599.82,food,Joe Williams,CURRENT
cb87779a-e173-4ddf-8998-caa5bf307059,bank_d_02.uk,Interest Fee,2017-10-13,488489.23,-278.95,fee,Joe Williams,CURRENT
ea0ce585-9e6c-4745-9498-537faeae797e,bank_d_02.uk,Campus Books,2017-10-16,486910.62,-1578.61,education,Joe Williams,CURRENT
c116c8ce-0fdd-4a9f-b83e-d2aa0001e8ba,bank_d_02.uk,Trader Joe's,2017-10-17,486258.09,-652.53,food,Joe Williams,CURRENT
ab811301-629b-4279-8e6b-08f212c3fb47,bank_d_02.uk,The Gap,2017-10-17,484881.36,-1376.73,clothing,Joe Williams,CURRENT
20a184b9-381b-428e-9562-ac6f31e2bf89,bank_d_02.uk,AT&T,2017-10-22,482860.39,-2020.97,utility,Joe Williams,CURRENT
0fe7a46f-f5d7-4674-8521-b34ac9194761,bank_d_02.uk,Trader Joe's,2017-10-24,482489.96,-370.43,food,Joe Williams,CURRENT
27e7b012-6bd7-43e3-a138-42e86a53e091,bank_d_02.uk,Nordstrom,2017-11-01,482130.51,-359.45,gift,Joe Williams,CURRENT
48241d81-4f48-4f54-a996-b283a224cec4,bank_d_02.uk,Trader Joe's,2017-11-03,481737.27,-393.24,food,Joe Williams,CURRENT
a8d7a379-3384-4dd9-ace0-4bdac09873d1,bank_d_02.uk,INCOME,2017-10-08,2540000.00,30000.00,INCOME,Joe Williams,SAVING
a959fa82-892c-4963-8cb7-dc0613e31bed,bank_d_00.uk,INCOME,2017-10-08,960000.00,20000.00,INCOME,Ammy Williams,SAVING
f3ce6a69-3335-4352-95f5-1c53e7bbe0bd,bank_d_01.uk,INCOME,2017-10-08,716398.53,60000.00,INCOME,Ammy Williams,CURRENT
ceccfb82-2bae-46ee-851f-9b7f36142b9e,bank_d_01.uk,RENT,2017-10-08,696398.53,-20000.00,RENT,Ammy Williams,CURRENT
850e3231-7287-447c-b247-de051f14e07f,bank_d_01.uk,Dr. Jackson,2017-10-19,694945.10,-1453.43,health,Ammy Williams,CURRENT
70d3f31a-0b3c-478b-8960-33fae2c240a0,bank_d_01.uk,Tuition,2017-10-21,693643.29,-1301.81,education,Ammy Williams,CURRENT
a43bffc2-f891-4b28-a7e8-71ed5fcf5689,bank_d_01.uk,Safeway,2017-10-23,693272.27,-371.02,food,Ammy Williams,CURRENT
5c9362a1-40cc-4f1a-a883-c7bd4f22fffb,bank_d_01.uk,Macy's,2017-10-24,691886.99,-1385.28,clothing,Ammy Williams,CURRENT
e9a18218-e440-47e0-bf4a-00889fa634dc,bank_d_01.uk,Rhapsody,2017-10-25,691192.58,-694.41,entertainment,Ammy Williams,CURRENT
473000a0-87e8-4958-863e-dd5552bb7ed6,bank_d_01.uk,Safeway,2017-10-28,690881.84,-310.74,food,Ammy Williams,CURRENT
052fa228-aceb-4b9c-9103-4db1b661dcc0,bank_d_01.uk,Safeway,2017-10-28,690396.20,-485.64,food,Ammy Williams,CURRENT
a261a5ff-eb72-4929-8dbf-00ed46144d8d,bank_d_01.uk,Safeway,2017-10-30,689845.59,-550.61,food,Ammy Williams,CURRENT
a73e3580-3e57-4d3c-8514-385183bbd7f4,bank_d_01.uk,Chevron,2017-11-02,688726.82,-1118.77,auto,Ammy Williams,CURRENT
37c82998-6fa0-4929-bbf1-cf7fe229359f,bank_d_01.uk,Apple Store,2017-11-04,688414.19,-312.63,gift,Ammy Williams,CURRENT
29b4843a-4a27-4303-9751-100aa490e128,bank_d_02.uk,INCOME,2017-11-07,514737.27,33000.00,INCOME,Joe Williams,CURRENT
aab9e717-ccd6-4bef-87ed-46ae890a2820,bank_d_02.uk,Trader Joe's,2017-11-07,514206.88,-530.39,food,Joe Williams,CURRENT
a79ecdc5-04ea-4fbe-8c50-03336b79b427,bank_d_02.uk,Rhapsody,2017-11-10,513686.87,-520.01,entertainment,Joe Williams,CURRENT
7702ed91-ca88-4c48-9ec0-3e26d73100f2,bank_d_02.uk,Banana Republic,2017-11-14,512695.14,-991.73,clothing,Joe Williams,CURRENT
d98c640d-6765-4a29-89d2-0fc728a326e7,bank_d_02.uk,Campus Books,2017-11-14,510958.53,-1736.61,education,Joe Williams,CURRENT
cf3a9256-5239-4efb-a3ab-131d9d4f6bc1,bank_d_02.uk,Trader Joe's,2017-11-15,510398.08,-560.45,food,Joe Williams,CURRENT
dc4af7f4-2677-4a13-90f4-083dc7f9cdf9,bank_d_02.uk,Trader Joe's,2017-11-21,510030.55,-367.53,food,Joe Williams,CURRENT
0f23b458-d6d7-4ae0-8d32-f2491e0c6b62,bank_d_02.uk,Trader Joe's,2017-11-25,509646.63,-383.92,food,Joe Williams,CURRENT
3871bf28-befa-414e-aabd-7157f267237e,bank_d_02.uk,Pep Boys,2017-11-25,508312.63,-1334.00,auto,Joe Williams,CURRENT
9a39b22e-5432-4744-8130-8e87b6ecbadd,bank_d_02.uk,Wal-Mart,2017-11-29,507211.92,-1100.71,health,Joe Williams,CURRENT
0f82cb21-b10d-422b-aa4d-dc147d6e8a7f,bank_d_02.uk,Trader Joe's,2017-12-01,506879.16,-332.76,food,Joe Williams,CURRENT
2b8564d3-272c-4c06-b396-0e63837801ca,bank_d_02.uk,AT&T,2017-12-04,505074.35,-1804.81,utility,Joe Williams,CURRENT
0eddaba4-8152-470d-8a97-79a4dd65af1c,bank_d_02.uk,INCOME,2017-11-07,2570000.00,30000.00,INCOME,Joe Williams,SAVING
42f60b54-f1ce-440d-b563-05a92672e83e,bank_d_00.uk,INCOME,2017-11-07,980000.00,20000.00,INCOME,Ammy Williams,SAVING
50d12dc9-ca65-4c1d-9ce7-8b834521acb3,bank_d_01.uk,INCOME,2017-11-07,748414.19,60000.00,INCOME,Ammy Williams,CURRENT
b4766031-93a0-46bb-80c8-0d6f573fbb22,bank_d_01.uk,Trader Joe's,2017-11-07,747739.95,-674.24,food,Ammy Williams,CURRENT
020ac741-a042-447c-a810-c7cf3acc4a30,bank_d_01.uk,Trader Joe's,2017-11-07,747209.68,-530.27,food,Ammy Williams,CURRENT
9a83a2cf-c729-4767-b507-c063682f07fa,bank_d_01.uk,RENT,2017-11-07,727209.68,-20000.00,RENT,Ammy Williams,CURRENT
9d5658fd-5416-4cd9-b3af-945f9b538403,bank_d_01.uk,Trader Joe's,2017-11-08,726722.98,-486.70,food,Ammy Williams,CURRENT
82a5a44f-3df0-46e6-80ce-9596ba6f9e03,bank_d_01.uk,Trader Joe's,2017-11-10,726017.89,-705.09,food,Ammy Williams,CURRENT
7d4b75f6-fa54-42c5-8f50-83875035d5cb,bank_d_01.uk,Neiman-Marcus,2017-11-13,725619.88,-398.01,gift,Ammy Williams,CURRENT
86292aaf-ed3e-470c-81b0-5e2db6a70f87,bank_d_01.uk,Trader Joe's,2017-11-19,725256.83,-363.05,food,Ammy Williams,CURRENT
20223542-95ed-43e6-9257-71a3568a7ced,bank_d_01.uk,Rhapsody,2017-11-26,724689.51,-567.32,entertainment,Ammy Williams,CURRENT
d6420533-0e0e-4a9a-9949-f2eb38cf0f3e,bank_d_01.uk,PG&E,2017-11-27,723061.50,-1628.01,utility,Ammy Williams,CURRENT
884dc631-491a-4971-826c-9a33ae3d8b16,bank_d_01.uk,J. Crew,2017-11-27,722284.92,-776.58,clothing,Ammy Williams,CURRENT
ee563dba-78df-416f-a1df-66fbb1f21b43,bank_d_01.uk,Dr. Phillips,2017-12-01,720385.67,-1899.25,health,Ammy Williams,CURRENT
b4b1d383-06f4-4749-be4f-fa6e0775fae6,bank_d_01.uk,Jiffy Lube,2017-12-02,718564.88,-1820.79,auto,Ammy Williams,CURRENT
20a8f17e-55e4-4cce-bef7-5f80719ff4aa,bank_d_01.uk,Trader Joe's,2017-12-07,718010.15,-554.73,food,Ammy Williams,CURRENT
8ad1a8e4-d06c-418d-86c5-f5a03d3ae640,bank_d_02.uk,INCOME,2017-12-07,538074.35,33000.00,INCOME,Joe Williams,CURRENT
9ec7f455-a918-4fe2-a9b6-481dc037ff59,bank_d_02.uk,Safeway,2017-12-07,537710.55,-363.80,food,Joe Williams,CURRENT
a4adcab0-b32f-4e4f-85b5-32c06f183d06,bank_d_02.uk,Safeway,2017-12-10,537075.90,-634.65,food,Joe Williams,CURRENT
2dd00cd8-7a26-4cdb-a43d-b113c5c9e621,bank_d_02.uk,Dr. Jackson,2017-12-11,535457.91,-1617.99,health,Joe Williams,CURRENT
4f44122b-9bcb-4343-af92-9cb0b524cceb,bank_d_02.uk,Banana Republic,2017-12-13,534705.01,-752.90,clothing,Joe Williams,CURRENT
915b8515-9d08-4f9a-af9c-d5ee87c85a2c,bank_d_02.uk,Amazon.com,2017-12-22,534214.77,-490.24,gift,Joe Williams,CURRENT
1d99340f-3b8e-41d5-bd0a-8e14be286faf,bank_d_02.uk,Brinks,2017-12-24,533046.21,-1168.56,utility,Joe Williams,CURRENT
1a208d51-c96d-42d8-ac57-05a5f082a224,bank_d_02.uk,Safeway,2017-12-25,532520.76,-525.45,food,Joe Williams,CURRENT
1412ab04-880f-4fdc-83f0-a8e0f7bbaeb7,bank_d_02.uk,Safeway,2017-12-27,532085.28,-435.48,food,Joe Williams,CURRENT
635a4f4e-9976-4f1f-9660-59771c078d9f,bank_d_02.uk,Registration,2017-12-29,531005.73,-1079.55,education,Joe Williams,CURRENT
199e224c-bdf5-421c-af08-2627204b1c26,bank_d_02.uk,Rhapsody,2018-01-01,530491.65,-514.08,entertainment,Joe Williams,CURRENT
696d4d78-a0fc-4221-83a3-23bc4d12267a,bank_d_02.uk,Safeway,2018-01-05,529997.32,-494.33,food,Joe Williams,CURRENT
90a0b568-81e5-417f-83cd-493210dad255,bank_d_02.uk,Safeway,2018-01-05,529642.34,-354.98,food,Joe Williams,CURRENT
b439b031-c716-4186-a602-8d09337207bf,bank_d_02.uk,INCOME,2017-12-07,2600000.00,30000.00,INCOME,Joe Williams,SAVING
b9b17b71-ca30-4242-8bcf-fb11b51579f3,bank_d_00.uk,INCOME,2017-12-07,1000000.00,20000.00,INCOME,Ammy Williams,SAVING
44bb2f69-1fdd-4798-b5f3-b76cc8ceb142,bank_d_01.uk,INCOME,2017-12-07,778010.15,60000.00,INCOME,Ammy Williams,CURRENT
d7772cd3-fe4e-4cb6-b2f0-c8773be60597,bank_d_01.uk,Trader Joe's,2017-12-07,777631.14,-379.01,food,Ammy Williams,CURRENT
823a9297-9e01-41e8-920f-5d92df05d0e2,bank_d_01.uk,RENT,2017-12-07,757631.14,-20000.00,RENT,Ammy Williams,CURRENT
eaf56422-4ccb-45e5-b5e4-5439be664366,bank_d_01.uk,AT&T,2017-12-09,755112.94,-2518.20,utility,Ammy Williams,CURRENT
c1143ffd-4f39-4941-8b9c-de6d19f4d965,bank_d_01.uk,Rhapsody,2017-12-09,754373.45,-739.49,entertainment,Ammy Williams,CURRENT
bc856c9a-8748-42cc-8da6-a9566d541e97,bank_d_01.uk,Trader Joe's,2017-12-12,753802.38,-571.07,food,Ammy Williams,CURRENT
3a91efe2-3a32-4cad-a7b8-3fd654cf1964,bank_d_01.uk,Trader Joe's,2017-12-18,753113.18,-689.20,food,Ammy Williams,CURRENT
2c59d9fe-0504-4866-822c-81a05c372221,bank_d_01.uk,Amazon.com,2017-12-18,751755.91,-1357.27,education,Ammy Williams,CURRENT
df035adc-da89-46a1-a589-821cbf0f2438,bank_d_01.uk,Trader Joe's,2017-12-20,751218.83,-537.08,food,Ammy Williams,CURRENT
9f78efb8-1ab4-4b8d-b77a-829b7d7e2a93,bank_d_01.uk,Trader Joe's,2017-12-30,750654.47,-564.36,food,Ammy Williams,CURRENT
bda7511d-4abb-4c27-ac41-511ed553514b,bank_d_01.uk,Walgreen's,2018-01-02,749002.86,-1651.61,health,Ammy Williams,CURRENT
5b617fa8-71ff-4d5d-acfd-356f0cd6350f,bank_d_01.uk,Neiman-Marcus,2018-01-02,748513.48,-489.38,gift,Ammy Williams,CURRENT
2357efdf-e317-4901-b3e4-1c539403ad9a,bank_d_01.uk,Trader Joe's,2018-01-03,748001.91,-511.57,food,Ammy Williams,CURRENT
498785c4-864d-4683-8569-d3ba0de05233,bank_d_01.uk,J. Crew,2018-01-05,746779.40,-1222.51,clothing,Ammy Williams,CURRENT
ed491d63-4e18-4f19-a5e4-231235094e54,bank_d_02.uk,INCOME,2018-01-06,562642.34,33000.00,INCOME,Joe Williams,CURRENT
713ee500-caee-4e08-87c7-b251720e8cd0,bank_d_02.uk,In-N-Out Burger,2018-01-07,562271.05,-371.29,food,Joe Williams,CURRENT
b2c1be5b-629d-43bb-bb71-4299b0245df7,bank_d_02.uk,Campus Books,2018-01-07,560726.02,-1545.03,education,Joe Williams,CURRENT
8be5385b-0bcd-4cad-98dc-7fd8e3c2c677,bank_d_02.uk,In-N-Out Burger,2018-01-11,560275.69,-450.33,food,Joe Williams,CURRENT
aaa3eb03-321b-480d-adf3-a39215ad5738,bank_d_02.uk,J. Crew,2018-01-14,559464.51,-811.18,clothing,Joe Williams,CURRENT
26c62a19-0e68-4b6d-a71a-12666c786dd4,bank_d_02.uk,Apple Store,2018-01-17,559121.60,-342.91,gift,Joe Williams,CURRENT
93b7ea16-7383-4e36-a47a-6ec8e6219711,bank_d_02.uk,Union 76,2018-01-18,557959.60,-1162.00,auto,Joe Williams,CURRENT
2368ea8c-3383-45c3-9a34-5b6c54b21f71,bank_d_02.uk,Wal-Mart,2018-01-22,556914.89,-1044.71,health,Joe Williams,CURRENT
eb15a50e-af79-41de-bb14-548acc2b4d0a,bank_d_02.uk,In-N-Out Burger,2018-01-29,556208.01,-706.88,food,Joe Williams,CURRENT
c02da5f7-fcb9-47a4-951a-4dca6484419b,bank_d_02.uk,Netflix,2018-01-29,555647.07,-560.94,entertainment,Joe Williams,CURRENT
aab950fb-45db-4f4f-844c-a44cc8bd5efd,bank_d_02.uk,In-N-Out Burger,2018-01-30,555186.97,-460.10,food,Joe Williams,CURRENT
5dc9db43-4656-42ed-87bd-08a8f0e69198,bank_d_02.uk,In-N-Out Burger,2018-02-02,554628.86,-558.11,food,Joe Williams,CURRENT
5a9a5355-3470-4723-a7bf-5f16f1ddc940,bank_d_02.uk,INCOME,2018-01-06,2630000.00,30000.00,INCOME,Joe Williams,SAVING
d9dd4016-2f1b-4eac-87db-cdb01296567e,bank_d_00.uk,INCOME,2018-01-06,1020000.00,20000.00,INCOME,Ammy Williams,SAVING
42787859-c0b5-4e16-9750-cd7cea21af85,bank_d_01.uk,INCOME,2018-01-06,806779.40,60000.00,INCOME,Ammy Williams,CURRENT
2d07f285-ffcc-4d5c-ab47-d88db02e55f9,bank_d_01.uk,Wal-Mart,2018-01-06,805524.03,-1255.37,health,Ammy Williams,CURRENT
9f2800ee-200a-4490-9d45-f2318388f162,bank_d_01.uk,RENT,2018-01-06,785524.03,-20000.00,RENT,Ammy Williams,CURRENT
3f61e34d-8755-4bef-8686-d6cfb8a1a54b,bank_d_01.uk,Metreon Theaters,2018-01-09,784785.91,-738.12,entertainment,Ammy Williams,CURRENT
9eaacbe0-47f6-48cb-b49e-50a7d9794209,bank_d_01.uk,Olive Garden,2018-01-11,784087.08,-698.83,food,Ammy Williams,CURRENT
15481446-663a-402a-bce6-bfaab4149c09,bank_d_01.uk,Olive Garden,2018-01-12,783670.16,-416.92,food,Ammy Williams,CURRENT
88ca5e2a-5e40-4360-a8a9-c8237e58ec95,bank_d_01.uk,Amazon.com,2018-01-13,783157.39,-512.77,gift,Ammy Williams,CURRENT
50885d78-1c43-4500-9ee2-2a8c99bbbc8b,bank_d_01.uk,Brinks,2018-01-16,781993.01,-1164.38,utility,Ammy Williams,CURRENT
8d9e8c1b-afdb-4c8c-97ac-20456a3031bf,bank_d_01.uk,Arco,2018-01-18,780569.95,-1423.06,auto,Ammy Williams,CURRENT
62a3cd67-d8bb-411a-bbe6-02d8c4cae0b0,bank_d_01.uk,The Crucible,2018-01-19,779374.54,-1195.41,education,Ammy Williams,CURRENT
1074d1b9-0313-4832-b0f5-17bee98df87f,bank_d_01.uk,Olive Garden,2018-01-21,778849.54,-525.00,food,Ammy Williams,CURRENT
b9b91576-b812-4971-92f9-a532f464f7bc,bank_d_01.uk,The Gap,2018-01-26,777981.73,-867.81,clothing,Ammy Williams,CURRENT
4bcda921-8363-447d-a342-1f5a726c9240,bank_d_01.uk,Olive Garden,2018-01-30,777633.24,-348.49,food,Ammy Williams,CURRENT
9d2bad7e-a49b-4849-832a-239337bffa8c,bank_d_01.uk,Olive Garden,2018-02-01,777055.42,-577.82,food,Ammy Williams,CURRENT
5217d221-e51e-461c-ae49-0784d40ac07b,bank_d_02.uk,INCOME,2018-02-05,587628.86,33000.00,INCOME,Joe Williams,CURRENT
95d1f146-f80a-404a-887e-3144d25b916a,bank_d_02.uk,Netflix,2018-02-07,586979.86,-649.00,entertainment,Joe Williams,CURRENT
fef01127-6ee5-4236-86d0-e14da309ed66,bank_d_02.uk,J. Crew,2018-02-08,586149.45,-830.41,clothing,Joe Williams,CURRENT
90215409-a8be-4d88-9695-54add0d012c1,bank_d_02.uk,Shell,2018-02-08,584259.99,-1889.46,auto,Joe Williams,CURRENT
e0e95947-70b3-451b-8a08-e37e7fe55384,bank_d_02.uk,Nordstrom,2018-02-08,583997.51,-262.48,gift,Joe Williams,CURRENT
b0cd7282-fde4-42a2-b982-69ee1c678837,bank_d_02.uk,Dr. Jackson,2018-02-13,582754.55,-1242.96,health,Joe Williams,CURRENT
b88b86cf-f2f8-4318-83fe-94c6cc880e76,bank_d_02.uk,Starbucks,2018-02-14,582226.58,-527.97,food,Joe Williams,CURRENT
38a76c5c-ec22-4dca-aaf3-a5de8352d282,bank_d_02.uk,Starbucks,2018-02-19,581796.26,-430.32,food,Joe Williams,CURRENT
2ffe229e-ef0d-4996-bbbd-b853d5a6e02c,bank_d_02.uk,Starbucks,2018-02-21,581435.39,-360.87,food,Joe Williams,CURRENT
b4fb2ae5-4684-4389-b0f2-9b8af89043ab,bank_d_02.uk,Starbucks,2018-03-03,581035.49,-399.90,food,Joe Williams,CURRENT
ffd6f9ac-33c5-469a-9699-ae3128c1418f,bank_d_02.uk,Campus Books,2018-03-05,579405.85,-1629.64,education,Joe Williams,CURRENT
ea293103-02a9-40a4-9333-4e2d1e750f60,bank_d_02.uk,INCOME,2018-02-05,2660000.00,30000.00,INCOME,Joe Williams,SAVING
985ee45c-d02b-4d3c-9cf0-85b868ecc405,bank_d_00.uk,INCOME,2018-02-05,1040000.00,20000.00,INCOME,Ammy Williams,SAVING
a99d54f5-eb9a-41f8-b723-8bf10b6f9858,bank_d_01.uk,INCOME,2018-02-05,837055.42,60000.00,INCOME,Ammy Williams,CURRENT
4b9b1c32-c893-4f80-b9f3-9e232ccce3f0,bank_d_01.uk,RENT,2018-02-05,817055.42,-20000.00,RENT,Ammy Williams,CURRENT
4a210acb-43b2-435c-b53f-e066767e82ff,bank_d_01.uk,Dr. Roberts,2018-02-06,815594.66,-1460.76,health,Ammy Williams,CURRENT
a5de03e0-0e40-4905-ba03-e71f471221cf,bank_d_01.uk,Nordstrom,2018-02-07,815069.19,-525.47,gift,Ammy Williams,CURRENT
4b436534-cfd7-4cdf-8c40-05760c2bb344,bank_d_01.uk,Brinks,2018-02-11,813178.75,-1890.44,utility,Ammy Williams,CURRENT
92ea3eed-1f4b-4a99-b4ed-1ef11e5c604c,bank_d_01.uk,Whole Foods,2018-02-12,812516.28,-662.47,food,Ammy Williams,CURRENT
9ac15b8c-e8ca-430c-8c41-4c6e6d69076a,bank_d_01.uk,Amazon.com,2018-02-13,812062.89,-453.39,entertainment,Ammy Williams,CURRENT
32ee940e-c5f5-4a76-ac76-52f107725a13,bank_d_01.uk,Amazon.com,2018-02-17,810952.92,-1109.97,education,Ammy Williams,CURRENT
78a5046a-7a3f-4151-bbe3-7f265107cb49,bank_d_01.uk,Whole Foods,2018-02-18,810283.79,-669.13,food,Ammy Williams,CURRENT
2d4e61ad-d260-4de6-9669-93b823a51a09,bank_d_01.uk,Whole Foods,2018-02-23,809920.63,-363.16,food,Ammy Williams,CURRENT
ae7ac8f0-7092-4cc2-8302-0e22a99c46f5,bank_d_01.uk,Whole Foods,2018-02-26,809265.32,-655.31,food,Ammy Williams,CURRENT
f9e4b04b-4f05-44d9-a0db-cc528afc4636,bank_d_01.uk,The Gap,2018-03-01,808198.99,-1066.33,clothing,Ammy Williams,CURRENT
395e40e4-8be5-4f7c-b545-ad06435a3f32,bank_d_01.uk,Monthly Fee,2018-03-03,807696.29,-502.70,fee,Ammy Williams,CURRENT
71f1721c-fa37-4f94-8392-a55303118832,bank_d_01.uk,Whole Foods,2018-03-05,807309.24,-387.05,food,Ammy Williams,CURRENT
f235f8bd-4419-4917-832d-1dc7a81c0f97,bank_d_02.uk,INCOME,2018-03-07,612405.85,33000.00,INCOME,Joe Williams,CURRENT
0fb6ace2-653f-4301-b3fc-514ea6d362e4,bank_d_02.uk,Trader Joe's,2018-03-08,611823.31,-582.54,food,Joe Williams,CURRENT
b1a7053f-afec-4a4e-9041-d96780239df7,bank_d_02.uk,The Gap,2018-03-20,610926.25,-897.06,clothing,Joe Williams,CURRENT
94589f8c-836e-4bd5-8d09-086dea22f77e,bank_d_02.uk,Rhapsody,2018-03-20,610187.27,-738.98,entertainment,Joe Williams,CURRENT
10e58671-3ed7-4dcd-b6d8-da115787f42e,bank_d_02.uk,Trader Joe's,2018-03-22,609483.62,-703.65,food,Joe Williams,CURRENT
e40a4469-9966-40b4-8d52-ceb5570ae57a,bank_d_02.uk,Union 76,2018-03-23,608143.42,-1340.20,auto,Joe Williams,CURRENT
abe64bb5-3937-4ed3-b174-c4fbdfb5af5e,bank_d_02.uk,The Crucible,2018-03-27,606914.95,-1228.47,education,Joe Williams,CURRENT
b649ff07-2198-4bfa-bd0b-eca981b37265,bank_d_02.uk,Neiman-Marcus,2018-03-30,606407.11,-507.84,gift,Joe Williams,CURRENT
7f30acde-c8af-44ea-acab-895c906252b5,bank_d_02.uk,Trader Joe's,2018-04-03,605979.58,-427.53,food,Joe Williams,CURRENT
ae1b9862-a355-484f-bf6c-9f8eb9108bd9,bank_d_02.uk,Trader Joe's,2018-04-04,605297.48,-682.10,food,Joe Williams,CURRENT
36fd4210-41ad-47f4-8139-5868641b40b3,bank_d_02.uk,Dr. Roberts,2018-04-05,603952.56,-1344.92,health,Joe Williams,CURRENT
2653a201-2177-4062-8eec-c07bfd6faaf0,bank_d_02.uk,INCOME,2018-03-07,2690000.00,30000.00,INCOME,Joe Williams,SAVING
61ebd91a-43d7-4e3f-bb78-eef5ecc6dbcf,bank_d_00.uk,INCOME,2018-03-07,1060000.00,20000.00,INCOME,Ammy Williams,SAVING
a9399241-5340-4050-a62c-48c68fc4fa82,bank_d_01.uk,INCOME,2018-03-07,867309.24,60000.00,INCOME,Ammy Williams,CURRENT
f3f014cb-534e-41d2-8263-6b52eb335da0,bank_d_01.uk,Neiman-Marcus,2018-03-07,866902.88,-406.36,gift,Ammy Williams,CURRENT
36382925-f984-445f-9e36-ec9f4800c26f,bank_d_01.uk,RENT,2018-03-07,846902.88,-20000.00,RENT,Ammy Williams,CURRENT
865505f7-73c7-4e38-a104-3b2826a95c54,bank_d_01.uk,Union 76,2018-03-12,845364.98,-1537.90,auto,Ammy Williams,CURRENT
e3ed5c55-125d-415e-9a9f-f9b98810e27e,bank_d_01.uk,Safeway,2018-03-14,844965.41,-399.57,food,Ammy Williams,CURRENT
847cd801-08ae-4736-b2c8-2cfb5a09bffa,bank_d_01.uk,Safeway,2018-03-15,844307.00,-658.41,food,Ammy Williams,CURRENT
1fe716e9-45e4-4978-97b3-7795c4c80516,bank_d_01.uk,Safeway,2018-03-17,843976.09,-330.91,food,Ammy Williams,CURRENT
2c7590cc-78e4-43a0-a579-8eb7818a1182,bank_d_01.uk,Dr. Roberts,2018-03-22,843027.65,-948.44,health,Ammy Williams,CURRENT
ec2a5f4f-1f5b-4f4a-85a4-4a859890aec9,bank_d_01.uk,Amazon.com,2018-03-22,841921.14,-1106.51,education,Ammy Williams,CURRENT
96c2dad4-c60e-4e5a-ac07-d0a71f171449,bank_d_01.uk,Safeway,2018-03-25,841315.35,-605.79,food,Ammy Williams,CURRENT
1d75ded7-0ae5-4075-a4fc-84c60c07c6b3,bank_d_01.uk,Safeway,2018-03-25,840970.32,-345.03,food,Ammy Williams,CURRENT
3c3ba965-8d7e-4d8f-8e43-6ab9906d7de6,bank_d_01.uk,Amazon.com,2018-03-25,840268.15,-702.17,entertainment,Ammy Williams,CURRENT
6409c6ec-d0a4-43a7-a977-60df9ed3b28d,bank_d_01.uk,Banana Republic,2018-04-01,839043.58,-1224.57,clothing,Ammy Williams,CURRENT
043d48d2-4f80-4dc0-ada3-ce315f822d98,bank_d_01.uk,Safeway,2018-04-05,838575.90,-467.68,food,Ammy Williams,CURRENT
f627f0b3-082e-46ac-9529-d662c180d9db,bank_d_02.uk,INCOME,2018-04-06,636952.56,33000.00,INCOME,Joe Williams,CURRENT
7584bb5b-0d3a-4b27-a07b-f1addf7d4cb7,bank_d_02.uk,Whole Foods,2018-04-07,636466.53,-486.03,food,Joe Williams,CURRENT
290f5f4b-c753-4291-8c87-11deac39317b,bank_d_02.uk,Apple Store,2018-04-07,635985.67,-480.86,gift,Joe Williams,CURRENT
541a4419-1617-4dda-ab48-68ff943180ab,bank_d_02.uk,Tuition,2018-04-07,635160.66,-825.01,education,Joe Williams,CURRENT
ea12a4b5-4f2e-4181-a0f4-2c03fcf0e5f1,bank_d_02.uk,Whole Foods,2018-04-09,634788.73,-371.93,food,Joe Williams,CURRENT
bc1e99cd-2510-477e-b545-accbb75fad7b,bank_d_02.uk,,2018-04-12,632544.56,-2244.17,utility,Joe Williams,CURRENT
fb01f8fc-e153-48aa-a9cc-5d4322697852,bank_d_02.uk,The Gap,2018-04-18,631160.18,-1384.38,clothing,Joe Williams,CURRENT
0a9cb576-db3e-4d44-bb8c-64bc685fe1f6,bank_d_02.uk,Chevron,2018-04-21,630235.69,-924.49,auto,Joe Williams,CURRENT
ee2554c3-d799-47d5-8ce2-3fcaa1708eba,bank_d_02.uk,Whole Foods,2018-04-24,629645.36,-590.33,food,Joe Williams,CURRENT
96e575e2-0590-4e4f-bcd8-4c46e18154dd,bank_d_02.uk,Amazon.com,2018-04-28,629231.82,-413.54,entertainment,Joe Williams,CURRENT
a60ddd88-f199-44a1-a1c8-e7352a5cd863,bank_d_02.uk,Whole Foods,2018-05-04,628804.36,-427.46,food,Joe Williams,CURRENT
b559c7a9-78b1-40be-9b09-cee6ed2d0a9a,bank_d_02.uk,Wal-Mart,2018-05-04,627800.96,-1003.40,health,Joe Williams,CURRENT
6dfa4d48-8f13-404f-b7c4-199083a63419,bank_d_02.uk,INCOME,2018-04-06,2720000.00,30000.00,INCOME,Joe Williams,SAVING
5f47ecea-47c9-42f4-be56-c7692e175a35,bank_d_00.uk,INCOME,2018-04-06,1080000.00,20000.00,INCOME,Ammy Williams,SAVING
6dce3f2f-9751-4738-868e-75633e032088,bank_d_01.uk,INCOME,2018-04-06,898575.90,60000.00,INCOME,Ammy Williams,CURRENT
ab23ba15-4031-4c65-99e6-d9a8b0682a07,bank_d_01.uk,RENT,2018-04-06,878575.90,-20000.00,RENT,Ammy Williams,CURRENT
0db044d5-84a6-421e-8d03-58a0bf99a2c4,bank_d_01.uk,Jiffy Lube,2018-04-07,876668.21,-1907.69,auto,Ammy Williams,CURRENT
0252e5a9-e75a-4932-ad09-8991a0debc06,bank_d_01.uk,Starbucks,2018-04-08,876045.00,-623.21,food,Ammy Williams,CURRENT
c3a42533-3721-4705-ada2-6afce0e9d823,bank_d_01.uk,AMC Theaters,2018-04-12,875228.14,-816.86,entertainment,Ammy Williams,CURRENT
76577079-e3ae-444b-a96d-8ab11f5f9a92,bank_d_01.uk,Starbucks,2018-04-13,874632.70,-595.44,food,Ammy Williams,CURRENT
d89712fb-1bba-4199-90c7-8054b249b4a4,bank_d_01.uk,Starbucks,2018-04-15,873976.28,-656.42,food,Ammy Williams,CURRENT
a1f54f0b-e669-4b21-ba3b-0fbd489c3d20,bank_d_01.uk,The Crucible,2018-04-16,873017.58,-958.70,education,Ammy Williams,CURRENT
5dd09666-d967-4354-a021-9aba728fd30b,bank_d_01.uk,Starbucks,2018-04-18,872349.41,-668.17,food,Ammy Williams,CURRENT
447f0867-3d49-4477-97fd-1deff3563616,bank_d_01.uk,Starbucks,2018-04-21,871943.91,-405.50,food,Ammy Williams,CURRENT
5bc1c212-157c-42db-98bb-8187b40a8ffc,bank_d_01.uk,Starbucks,2018-04-21,871542.53,-401.38,food,Ammy Williams,CURRENT
bff745ae-1d6d-477c-ae81-e39f4099ff15,bank_d_01.uk,PG&E,2018-04-25,870158.43,-1384.10,utility,Ammy Williams,CURRENT
f6928e40-b2c5-45eb-a2fd-f75c15f4b842,bank_d_01.uk,J. Crew,2018-04-26,868739.46,-1418.97,clothing,Ammy Williams,CURRENT
8e19d20c-6602-4d28-a223-c228a1c56996,bank_d_01.uk,Dr. Phillips,2018-05-02,867392.37,-1347.09,health,Ammy Williams,CURRENT
2c0c8b09-b396-43ab-892a-a774c4ca2730,bank_d_01.uk,Monthly Fee,2018-05-05,866925.90,-466.47,fee,Ammy Williams,CURRENT
fdd74e88-d39e-4e7f-9ca5-ee58711ef8ea,bank_d_02.uk,INCOME,2018-05-06,660800.96,33000.00,INCOME,Joe Williams,CURRENT
9fb76c19-bd20-4c2d-b345-9ba91c46455d,bank_d_02.uk,Trader Joe's,2018-05-08,660139.21,-661.75,food,Joe Williams,CURRENT
9960f6d7-e749-4a4d-92d3-336c8898158a,bank_d_02.uk,Trader Joe's,2018-05-08,659500.76,-638.45,food,Joe Williams,CURRENT
add0bfb6-1d96-4408-a7f4-50d3491b63d2,bank_d_02.uk,Nordstrom,2018-05-11,659262.27,-238.49,gift,Joe Williams,CURRENT
f6641900-3bd9-48a3-94c0-279c52f2e935,bank_d_02.uk,Kenneth Cole,2018-05-12,658050.15,-1212.12,clothing,Joe Williams,CURRENT
c98a19e9-7b1d-429e-9db9-62b1bc8c8da1,bank_d_02.uk,Walgreen's,2018-05-14,656245.14,-1805.01,health,Joe Williams,CURRENT
d25f0994-1481-4e20-8284-ea1dd0a83c09,bank_d_02.uk,Metreon Theaters,2018-05-17,655716.03,-529.11,entertainment,Joe Williams,CURRENT
32b172cb-ac9f-446c-ad08-522f3c93d015,bank_d_02.uk,Trader Joe's,2018-05-19,655256.20,-459.83,food,Joe Williams,CURRENT
d1359b2c-c574-4f3f-b8a9-85e5c711c6c3,bank_d_02.uk,Trader Joe's,2018-05-19,654868.75,-387.45,food,Joe Williams,CURRENT
e80c8ebb-3531-422d-9737-e0aeb5d44175,bank_d_02.uk,Trader Joe's,2018-05-24,654546.76,-321.99,food,Joe Williams,CURRENT
0c65ef67-d229-4eba-9879-8c7e539a51e0,bank_d_02.uk,Jiffy Lube,2018-05-29,653272.55,-1274.21,auto,Joe Williams,CURRENT
3f497ced-1d35-47c0-b563-f5af0dc88dfa,bank_d_02.uk,Comcast,2018-06-01,651429.10,-1843.45,utility,Joe Williams,CURRENT
ed16be2b-a7fd-47a3-be40-c5d48676439a,bank_d_02.uk,Annual Fee,2018-06-02,650933.63,-495.47,fee,Joe Williams,CURRENT
dbb03091-49f2-4a35-b14f-ef391c736e32,bank_d_02.uk,Trader Joe's,2018-06-04,650335.16,-598.47,food,Joe Williams,CURRENT
1fdb0187-98e9-4188-8031-e2c8b8d2d377,bank_d_02.uk,Campus Books,2018-06-04,649189.79,-1145.37,education,Joe Williams,CURRENT
d8a867f4-a9de-42c9-beb4-ac65a0bf45ce,bank_d_02.uk,INCOME,2018-05-06,2750000.00,30000.00,INCOME,Joe Williams,SAVING
fd1690d0-451a-47cf-abdc-cfc0c02019e4,bank_d_00.uk,INCOME,2018-05-06,1100000.00,20000.00,INCOME,Ammy Williams,SAVING
c3fe1ccb-d1f0-4830-9a5a-64d8e9239d3b,bank_d_01.uk,INCOME,2018-05-06,926925.90,60000.00,INCOME,Ammy Williams,CURRENT
cb8a618b-e2ae-4114-bd87-f5fe26857ded,bank_d_01.uk,Whole Foods,2018-05-06,926547.96,-377.94,food,Ammy Williams,CURRENT
f306e66f-4855-4068-b8a6-75b521d126b1,bank_d_01.uk,RENT,2018-05-06,906547.96,-20000.00,RENT,Ammy Williams,CURRENT
309193c2-4019-4f4b-ae18-fb4ecf1c343d,bank_d_01.uk,Metreon Theaters,2018-05-07,906113.66,-434.30,entertainment,Ammy Williams,CURRENT
a4a57fe6-7691-486b-8208-9c50ac03c511,bank_d_01.uk,Apple Store,2018-05-10,905627.72,-485.94,gift,Ammy Williams,CURRENT
6a84a198-0243-4f20-9f91-dc9f73e360fc,bank_d_01.uk,Amazon.com,2018-05-18,904783.23,-844.49,education,Ammy Williams,CURRENT
3d661b40-29fb-440c-afa7-097a9d4dff86,bank_d_01.uk,Dr. Martins,2018-05-25,903284.70,-1498.53,health,Ammy Williams,CURRENT
100c12ab-bc39-49c0-99dc-0eeb114c237f,bank_d_01.uk,Nordstrom,2018-05-26,901998.71,-1285.99,clothing,Ammy Williams,CURRENT
4e61ca76-2513-46f0-9814-be3110e2bc0c,bank_d_01.uk,Jiffy Lube,2018-05-26,900814.03,-1184.68,auto,Ammy Williams,CURRENT
8adf44cc-3c9e-46a0-8b99-969120d80fd7,bank_d_01.uk,Whole Foods,2018-06-01,900392.86,-421.17,food,Ammy Williams,CURRENT
1ac6609f-230d-41e3-9df9-ee0b7c9ab363,bank_d_01.uk,Whole Foods,2018-06-01,899695.62,-697.24,food,Ammy Williams,CURRENT
42b6fcaa-e520-4281-ba1b-205eb2c0ac42,bank_d_01.uk,Verizon,2018-06-02,897293.92,-2401.70,utility,Ammy Williams,CURRENT
09155679-204c-4925-9bec-2f645df77e48,bank_d_01.uk,Whole Foods,2018-06-04,896689.03,-604.89,food,Ammy Williams,CURRENT
c1e02bff-ea1a-4cd3-bcfa-5bdba99f2da1,bank_d_02.uk,INCOME,2018-06-05,682189.79,33000.00,INCOME,Joe Williams,CURRENT
1d5b7062-5998-4b4d-8d71-f8724aab6e41,bank_d_02.uk,Safeway,2018-06-09,681537.81,-651.98,food,Joe Williams,CURRENT
5d3d4cbc-01fe-4daa-bd7a-43222d126874,bank_d_02.uk,Safeway,2018-06-09,680942.51,-595.30,food,Joe Williams,CURRENT
edabb918-97b8-412b-ade3-88b7078ef752,bank_d_02.uk,Metreon Theaters,2018-06-19,680123.80,-818.71,entertainment,Joe Williams,CURRENT
e3d5162e-9311-4955-9a4d-03c7267efb69,bank_d_02.uk,Comcast,2018-06-20,678543.35,-1580.45,utility,Joe Williams,CURRENT
2e4770e3-f767-4298-a81d-e2c21b359098,bank_d_02.uk,Safeway,2018-06-21,677948.86,-594.49,food,Joe Williams,CURRENT
40522f41-77bd-4787-b9f0-1f5d4be3564d,bank_d_02.uk,Apple Store,2018-06-22,677510.62,-438.24,gift,Joe Williams,CURRENT
fde4bf7a-3526-4308-8143-d3d2a9e217a6,bank_d_02.uk,Safeway,2018-06-24,676818.66,-691.96,food,Joe Williams,CURRENT
523d2e14-728e-4119-9f2d-a4c9b2a1a944,bank_d_02.uk,Amazon.com,2018-06-26,675977.85,-840.81,education,Joe Williams,CURRENT
01370043-5988-44b0-8f5e-5ed03c21b26d,bank_d_02.uk,Dr. Jackson,2018-06-27,674375.02,-1602.83,health,Joe Williams,CURRENT
3766cf49-c61a-4ee4-bb59-61e6abdd3b2b,bank_d_02.uk,Safeway,2018-06-28,674058.92,-316.10,food,Joe Williams,CURRENT
30387ff1-fc96-4db1-8ef2-258dbdc724e9,bank_d_02.uk,Arco,2018-06-29,673194.94,-863.98,auto,Joe Williams,CURRENT
23dd96c4-21bb-4853-a479-4ab5e28bdaf7,bank_d_02.uk,Safeway,2018-06-30,672800.52,-394.42,food,Joe Williams,CURRENT
c7792d8e-51f3-45d3-8d3b-1474e5ac511e,bank_d_02.uk,Macy's,2018-07-02,671896.62,-903.90,clothing,Joe Williams,CURRENT
c98a195a-35a5-4a64-b0ba-8b224623da8f,bank_d_02.uk,INCOME,2018-06-05,2780000.00,30000.00,INCOME,Joe Williams,SAVING
492596f1-f71c-405e-916b-357c4e9a24e2,bank_d_00.uk,INCOME,2018-06-05,1120000.00,20000.00,INCOME,Ammy Williams,SAVING
0843bea6-c74f-4af3-8c58-4fac69d145ff,bank_d_01.uk,INCOME,2018-06-05,956689.03,60000.00,INCOME,Ammy Williams,CURRENT
b0f45986-9388-4cf4-b902-02c317c2094b,bank_d_01.uk,RENT,2018-06-05,936689.03,-20000.00,RENT,Ammy Williams,CURRENT
6710a042-9314-4b9d-8a2d-9289702966ef,bank_d_01.uk,Starbucks,2018-06-13,936223.95,-465.08,food,Ammy Williams,CURRENT
a5df619d-3a0d-4746-b68b-416334ae027e,bank_d_01.uk,PG&E,2018-06-18,934809.61,-1414.34,utility,Ammy Williams,CURRENT
18605658-e705-47d5-9871-daa3b97bc4b8,bank_d_01.uk,Starbucks,2018-06-19,934394.09,-415.52,food,Ammy Williams,CURRENT
4df8c1a0-5278-4024-a860-13ba22160cdb,bank_d_01.uk,Netflix,2018-06-21,933863.45,-530.64,entertainment,Ammy Williams,CURRENT
a7dbf32b-a1fa-490a-8203-48651f50b843,bank_d_01.uk,Starbucks,2018-06-24,933302.36,-561.09,food,Ammy Williams,CURRENT
914145b7-5e31-411b-9e8a-bd495be359f8,bank_d_01.uk,Amazon.com,2018-06-25,932931.20,-371.16,gift,Ammy Williams,CURRENT
9b3f5380-c3a9-4016-a1bd-c0cb6bc963de,bank_d_01.uk,Campus Books,2018-06-25,931695.88,-1235.32,education,Ammy Williams,CURRENT
86f30125-d018-4e86-a600-66c21886360c,bank_d_01.uk,Starbucks,2018-06-28,930997.01,-698.87,food,Ammy Williams,CURRENT
aa371125-aa7b-4c8b-85d1-64fa9217242b,bank_d_01.uk,Union 76,2018-06-28,929461.06,-1535.95,auto,Ammy Williams,CURRENT
2f772d1a-ffd8-4f90-b105-d9e531db53c3,bank_d_01.uk,Dr. Jackson,2018-07-01,928233.31,-1227.75,health,Ammy Williams,CURRENT
d4e78478-d816-47f3-9755-f9a9bff82043,bank_d_01.uk,Kenneth Cole,2018-07-03,926877.49,-1355.82,clothing,Ammy Williams,CURRENT
12ded794-091a-487e-acc8-8949d51b9b26,bank_d_02.uk,INCOME,2018-07-05,704896.62,33000.00,INCOME,Joe Williams,CURRENT
c6c97214-fb9d-47e0-9263-89ce77268cc4,bank_d_02.uk,iTunes Music Store,2018-07-05,704442.79,-453.83,entertainment,Joe Williams,CURRENT
8a8bf3ad-8d08-44f8-9699-39287a752905,bank_d_02.uk,Jiffy Lube,2018-07-10,702811.76,-1631.03,auto,Joe Williams,CURRENT
cdde4021-1ad7-4b4c-b476-c64bf3d3a47f,bank_d_02.uk,Whole Foods,2018-07-14,702369.83,-441.93,food,Joe Williams,CURRENT
f38ee636-9b75-420a-95e4-a14575a6d5c1,bank_d_02.uk,Whole Foods,2018-07-14,701787.83,-582.00,food,Joe Williams,CURRENT
90d8b847-9c73-4e23-8d38-d2690a0cf812,bank_d_02.uk,,2018-07-14,699584.02,-2203.81,utility,Joe Williams,CURRENT
c29ff13a-c407-4f19-a9f2-a6cf797082f4,bank_d_02.uk,Amazon.com,2018-07-14,699066.96,-517.06,gift,Joe Williams,CURRENT
45bebe71-5522-432d-8885-f5043f60611a,bank_d_02.uk,Whole Foods,2018-07-15,698656.08,-410.88,food,Joe Williams,CURRENT
a173b6fe-745b-447f-94bd-7a6450781b49,bank_d_02.uk,Interest Fee,2018-07-18,698380.12,-275.96,fee,Joe Williams,CURRENT
39d5ba5c-0475-412e-8150-ab3ec5dadcef,bank_d_02.uk,Whole Foods,2018-07-21,697735.33,-644.79,food,Joe Williams,CURRENT
4bb5379a-e7af-4b7f-a52e-98a6d664949b,bank_d_02.uk,Campus Books,2018-07-28,696063.07,-1672.26,education,Joe Williams,CURRENT
f6712ed7-7e21-4505-b9c1-6ffb9a0bc889,bank_d_02.uk,Whole Foods,2018-07-29,695512.69,-550.38,food,Joe Williams,CURRENT
11f8167b-acaf-4e6b-a0ed-8edff01c5ba9,bank_d_02.uk,Macy's,2018-07-30,694708.97,-803.72,clothing,Joe Williams,CURRENT
5d7a3a37-cbc3-4af8-949d-3c0e228895bd,bank_d_02.uk,Dr. Phillips,2018-07-30,692776.38,-1932.59,health,Joe Williams,CURRENT
13da637c-204f-4ecf-91f7-a9ae19ba373a,bank_d_02.uk,Whole Foods,2018-08-04,692101.68,-674.70,food,Joe Williams,CURRENT
765b692d-017f-4977-b4a9-e575e3280f62,bank_d_02.uk,INCOME,2018-07-05,2810000.00,30000.00,INCOME,Joe Williams,SAVING
1cdc1dbd-c5f2-409f-8fd6-a01c2813a269,bank_d_00.uk,INCOME,2018-07-05,1140000.00,20000.00,INCOME,Ammy Williams,SAVING
da393b92-10a7-42a5-89fa-0caa8b1df295,bank_d_01.uk,INCOME,2018-07-05,986877.49,60000.00,INCOME,Ammy Williams,CURRENT
29ff39cc-fa39-41cc-bab3-be587d29ffa7,bank_d_01.uk,RENT,2018-07-05,966877.49,-20000.00,RENT,Ammy Williams,CURRENT
572661a5-628f-48c8-9ccf-f2ec849fdbfa,bank_d_01.uk,Starbucks,2018-07-06,966457.85,-419.64,food,Ammy Williams,CURRENT
b56924a4-34cd-4b30-8b1b-d0aa1fac1758,bank_d_01.uk,Starbucks,2018-07-10,965828.58,-629.27,food,Ammy Williams,CURRENT
f8a1b045-496e-477a-8b17-1cbf855b0979,bank_d_01.uk,AMC Theaters,2018-07-11,965088.00,-740.58,entertainment,Ammy Williams,CURRENT
b1937708-177a-4428-9bd6-68b597aea794,bank_d_01.uk,Macy's,2018-07-12,964211.20,-876.80,clothing,Ammy Williams,CURRENT
042d5c90-707d-41c0-841c-ca40d98e6072,bank_d_01.uk,Starbucks,2018-07-13,963515.24,-695.96,food,Ammy Williams,CURRENT
2d0acee7-83c1-4577-830b-2ab3bc16a5b0,bank_d_01.uk,Starbucks,2018-07-17,962956.85,-558.39,food,Ammy Williams,CURRENT
7c0243cf-64bf-4223-9ce9-6a8c6d8a066e,bank_d_01.uk,,2018-07-20,961575.84,-1381.01,utility,Ammy Williams,CURRENT
1f84a9b0-1dd2-48d5-8d0f-91fd18cf66f4,bank_d_01.uk,Annual Fee,2018-07-27,961210.36,-365.48,fee,Ammy Williams,CURRENT
0dbbf206-19cc-4e67-b4b7-4bf3b7a3e22e,bank_d_01.uk,Dr. Jackson,2018-07-31,959722.33,-1488.03,health,Ammy Williams,CURRENT
bf23266a-efa1-4d08-8d42-e4cff82d2522,bank_d_01.uk,Tuition,2018-07-31,958437.08,-1285.25,education,Ammy Williams,CURRENT
37906a52-8220-4e9f-9190-2f5343afb1ef,bank_d_02.uk,INCOME,2018-08-04,725101.68,33000.00,INCOME,Joe Williams,CURRENT
0f73cd8d-66ab-4fb9-bc35-3b6ad6e048f6,bank_d_02.uk,Olive Garden,2018-08-04,724599.70,-501.98,food,Joe Williams,CURRENT
7c06153a-75c4-452c-bc5e-43235c609495,bank_d_02.uk,Neiman-Marcus,2018-08-05,724343.20,-256.50,gift,Joe Williams,CURRENT
b3e158f3-442a-4352-9f79-8362695f20f6,bank_d_02.uk,Arco,2018-08-09,723251.56,-1091.64,auto,Joe Williams,CURRENT
65da3262-c1a8-4b28-a50f-f8136823a9d4,bank_d_02.uk,AMC Theaters,2018-08-11,722796.93,-454.63,entertainment,Joe Williams,CURRENT
713de7c9-c891-42d9-8163-738805054073,bank_d_02.uk,Olive Garden,2018-08-15,722142.67,-654.26,food,Joe Williams,CURRENT
de7f15da-3268-4209-adfd-fe935f8dd329,bank_d_02.uk,Olive Garden,2018-08-21,721578.70,-563.97,food,Joe Williams,CURRENT
ed5db43f-4423-40d5-9686-e6354c700482,bank_d_02.uk,Brinks,2018-08-21,719256.21,-2322.49,utility,Joe Williams,CURRENT
909b181d-b4d5-43e2-8206-0283210e2f9b,bank_d_02.uk,Olive Garden,2018-08-22,718863.96,-392.25,food,Joe Williams,CURRENT
70811a64-416b-42bb-a373-eed697d2aefb,bank_d_02.uk,Banana Republic,2018-08-25,717428.04,-1435.92,clothing,Joe Williams,CURRENT
6eb3fd30-2ecc-4442-a981-3c50f2583dd7,bank_d_02.uk,Olive Garden,2018-08-29,716922.74,-505.30,food,Joe Williams,CURRENT
cde69ecb-084e-4f1e-8752-81ff149851f3,bank_d_02.uk,Walgreen's,2018-08-29,715571.01,-1351.73,health,Joe Williams,CURRENT
02e2dda3-ae97-40b1-a811-296fa3a592b1,bank_d_02.uk,Olive Garden,2018-08-30,714938.81,-632.20,food,Joe Williams,CURRENT
dc015ed5-4c10-4b08-91e8-00ae4aafc95b,bank_d_02.uk,INCOME,2018-08-04,2840000.00,30000.00,INCOME,Joe Williams,SAVING
b0777724-b4d5-4adf-8219-72ec273e355d,bank_d_00.uk,INCOME,2018-08-04,1160000.00,20000.00,INCOME,Ammy Williams,SAVING
f1160e48-5411-45f3-b1ed-0810a52de574,bank_d_01.uk,INCOME,2018-08-04,1018437.08,60000.00,INCOME,Ammy Williams,CURRENT
04245d7e-fdd3-48f9-bd8b-dbe49c0943c9,bank_d_01.uk,RENT,2018-08-04,998437.08,-20000.00,RENT,Ammy Williams,CURRENT
0e002da2-ef6f-4de9-aef3-95546af5bcce,bank_d_01.uk,The Crucible,2018-08-07,996976.53,-1460.55,education,Ammy Williams,CURRENT
070ba655-d3a6-4367-8bf5-91fe41773199,bank_d_01.uk,Dr. Roberts,2018-08-11,995186.55,-1789.98,health,Ammy Williams,CURRENT
0cd91184-675a-4234-8a24-31100b57d3c9,bank_d_01.uk,Whole Foods,2018-08-12,994617.66,-568.89,food,Ammy Williams,CURRENT
305fd502-bb0c-4db9-91d2-0df96d693cc7,bank_d_01.uk,Whole Foods,2018-08-16,994035.62,-582.04,food,Ammy Williams,CURRENT
b445b0c1-9e28-49ce-8a4d-257e31112185,bank_d_01.uk,Annual Fee,2018-08-16,993747.82,-287.80,fee,Ammy Williams,CURRENT
511075da-d630-4c18-92de-709e2ec56a0e,bank_d_01.uk,Whole Foods,2018-08-17,993202.45,-545.37,food,Ammy Williams,CURRENT
7b77843f-5031-43f1-97b3-61001475de8b,bank_d_01.uk,Whole Foods,2018-08-20,992523.24,-679.21,food,Ammy Williams,CURRENT
073b6a18-606b-41fa-b628-44d3b99e728d,bank_d_01.uk,Whole Foods,2018-08-23,992131.99,-391.25,food,Ammy Williams,CURRENT
76e639c8-7582-4287-a770-e1eb2e496808,bank_d_01.uk,Neiman-Marcus,2018-08-23,991793.48,-338.51,gift,Ammy Williams,CURRENT
ce432a95-71bc-475a-ba4f-f04dc60a8cc5,bank_d_01.uk,Banana Republic,2018-08-24,991064.90,-728.58,clothing,Ammy Williams,CURRENT
d40da559-710c-4d61-b359-7c4535f0ca72,bank_d_01.uk,Amazon.com,2018-08-27,990371.45,-693.45,entertainment,Ammy Williams,CURRENT
bffe17f6-89be-42c5-a56c-700fea2875a0,bank_d_01.uk,Whole Foods,2018-09-01,990049.82,-321.63,food,Ammy Williams,CURRENT
27435141-744f-460c-985a-88d4c55c8817,bank_d_01.uk,Chevron,2018-09-02,988408.22,-1641.60,auto,Ammy Williams,CURRENT
039efc3b-4766-40e2-941b-2635dde224f1,bank_d_02.uk,INCOME,2018-09-03,747938.81,33000.00,INCOME,Joe Williams,CURRENT
f548fa39-9119-4188-9e8b-c6447eb89c84,bank_d_02.uk,Olive Garden,2018-09-04,747502.00,-436.81,food,Joe Williams,CURRENT
76139cd7-a01b-4b7a-a5f0-051b17cb4ab9,bank_d_02.uk,,2018-09-04,745506.72,-1995.28,utility,Joe Williams,CURRENT
d81d4812-864d-42ed-8726-1bad35a203fc,bank_d_02.uk,Shell,2018-09-04,744000.50,-1506.22,auto,Joe Williams,CURRENT
38157588-63e6-4892-9f94-8a0ca6dd06ff,bank_d_02.uk,Late Fee,2018-09-11,743637.07,-363.43,fee,Joe Williams,CURRENT
69d10df9-2db8-4cd8-8a0a-239a17237653,bank_d_02.uk,Netflix,2018-09-17,743101.96,-535.11,entertainment,Joe Williams,CURRENT
67255d83-d3f7-413b-a334-06c8dc25809e,bank_d_02.uk,J. Crew,2018-09-18,741838.02,-1263.94,clothing,Joe Williams,CURRENT
0ac77c2f-84bc-485c-99cf-148097d0ba18,bank_d_02.uk,Apple Store,2018-09-21,741460.88,-377.14,gift,Joe Williams,CURRENT
f05dddb0-6e3f-492a-a469-94deccfa2210,bank_d_02.uk,Tuition,2018-09-22,740210.24,-1250.64,education,Joe Williams,CURRENT
dd09e453-a0ad-4040-8a0f-74cca4d49946,bank_d_02.uk,Olive Garden,2018-09-28,739498.53,-711.71,food,Joe Williams,CURRENT
9e4d0cc8-8963-4472-8e26-d6c7c2e43425,bank_d_02.uk,Olive Garden,2018-09-29,738932.18,-566.35,food,Joe Williams,CURRENT
54af7c22-d2b1-421e-97fd-d050d94c3ccc,bank_d_02.uk,Dr. Phillips,2018-09-30,736888.64,-2043.54,health,Joe Williams,CURRENT
b39b3c79-a020-48b6-8210-21e839c68b9f,bank_d_02.uk,Olive Garden,2018-10-01,736250.09,-638.55,food,Joe Williams,CURRENT
b2413e8d-0426-439e-92c3-3483a7f4c416,bank_d_02.uk,INCOME,2018-09-03,2870000.00,30000.00,INCOME,Joe Williams,SAVING
87eda615-3a93-4600-8dd0-f98a4c8d8426,bank_d_00.uk,INCOME,2018-09-03,1180000.00,20000.00,INCOME,Ammy Williams,SAVING
cc94cb51-946a-4ac0-b52c-536c68e30478,bank_d_01.uk,INCOME,2018-09-03,1048408.22,60000.00,INCOME,Ammy Williams,CURRENT
4069f14e-4622-4859-a3d0-c322b3de35c6,bank_d_01.uk,The Gap,2018-09-03,1047269.93,-1138.29,clothing,Ammy Williams,CURRENT
a6451fb1-2c73-4365-91ac-e4d6edbd010e,bank_d_01.uk,RENT,2018-09-03,1027269.93,-20000.00,RENT,Ammy Williams,CURRENT
484a8bfc-fee2-4113-8bf2-570349472136,bank_d_01.uk,Whole Foods,2018-09-08,1026643.36,-626.57,food,Ammy Williams,CURRENT
6c457f00-44b6-43c4-a974-d4b6ecf417ee,bank_d_01.uk,Registration,2018-09-11,1025704.17,-939.19,education,Ammy Williams,CURRENT
179f9ea9-0120-463f-9a5f-0601cd6be987,bank_d_01.uk,Whole Foods,2018-09-12,1025045.21,-658.96,food,Ammy Williams,CURRENT
370e7add-4eb0-42b6-ae9d-fcd2057a2a1e,bank_d_01.uk,Amazon.com,2018-09-13,1024634.65,-410.56,entertainment,Ammy Williams,CURRENT
52c8fd8c-a95e-426a-8296-c21aec1d7435,bank_d_01.uk,Arco,2018-09-14,1023034.25,-1600.40,auto,Ammy Williams,CURRENT
3bd2843d-9cbe-4d82-bc0c-0c46dcc8300a,bank_d_01.uk,Whole Foods,2018-09-24,1022579.93,-454.32,food,Ammy Williams,CURRENT
ab5ef217-7289-4836-bc05-aea438b94ec0,bank_d_01.uk,Whole Foods,2018-09-26,1022026.03,-553.90,food,Ammy Williams,CURRENT
c42b4a68-6578-4ea9-8ec8-b7bb712b1437,bank_d_01.uk,Dr. Roberts,2018-09-26,1020037.32,-1988.71,health,Ammy Williams,CURRENT
08bfcbb2-b29d-4dcd-bb48-d227d2901a12,bank_d_01.uk,Amazon.com,2018-10-03,1019688.71,-348.61,gift,Ammy Williams,CURRENT
4cb4910b-7087-4bb0-96a2-86ba7b768b01,bank_d_02.uk,INCOME,2018-10-03,769250.09,33000.00,INCOME,Joe Williams,CURRENT
537097eb-1f29-434a-95f7-1fccad2d757a,bank_d_02.uk,Trader Joe's,2018-10-04,768673.45,-576.64,food,Joe Williams,CURRENT
9459f65d-b5f6-48fd-84c3-c0563a4c97ed,bank_d_02.uk,Apple Store,2018-10-06,768312.67,-360.78,gift,Joe Williams,CURRENT
144f9b2c-a3b7-41cc-afa5-438e9e441950,bank_d_02.uk,Pep Boys,2018-10-10,766419.44,-1893.23,auto,Joe Williams,CURRENT
c91e7be5-d601-47a6-89cf-ebe9413cbcc0,bank_d_02.uk,Netflix,2018-10-12,765772.33,-647.11,entertainment,Joe Williams,CURRENT
570f8e70-2bef-4138-9d1c-c96f8ba3a81b,bank_d_02.uk,Trader Joe's,2018-10-16,765326.04,-446.29,food,Joe Williams,CURRENT
eae0fa58-78cd-448c-98e0-989960f2ffb9,bank_d_02.uk,Campus Books,2018-10-18,763806.66,-1519.38,education,Joe Williams,CURRENT
4a09ce47-98c2-4274-9ba2-6481f56e128c,bank_d_02.uk,Kenneth Cole,2018-10-19,762921.79,-884.87,clothing,Joe Williams,CURRENT
7ecd712d-9c02-4efe-a212-e8d039d70471,bank_d_02.uk,Comcast,2018-10-20,761590.26,-1331.53,utility,Joe Williams,CURRENT
6f7e30b4-11ff-4f20-90ca-2afe6c5af275,bank_d_02.uk,Trader Joe's,2018-10-22,761244.25,-346.01,food,Joe Williams,CURRENT
b4739f7a-f0f7-4da8-88f8-0260a78c8374,bank_d_02.uk,Trader Joe's,2018-10-23,760811.74,-432.51,food,Joe Williams,CURRENT
cb67e6a5-b849-4080-b814-97c4fb8aedfb,bank_d_02.uk,Trader Joe's,2018-10-23,760224.94,-586.80,food,Joe Williams,CURRENT
934562c8-db14-4434-a54b-3e2415d589ff,bank_d_02.uk,Dr. Jackson,2018-10-25,758747.75,-1477.19,health,Joe Williams,CURRENT
9cfea091-9089-4633-bc5f-061bc643e77f,bank_d_02.uk,Monthly Fee,2018-10-27,758356.10,-391.65,fee,Joe Williams,CURRENT
aebece7f-64a3-48c9-8586-5d59975d4dcb,bank_d_02.uk,Trader Joe's,2018-10-29,758014.56,-341.54,food,Joe Williams,CURRENT
8f92fe6c-c695-40d6-a9fa-f208d560b190,bank_d_02.uk,INCOME,2018-10-03,2900000.00,30000.00,INCOME,Joe Williams,SAVING
630b8d30-c2a2-43df-acf1-a36654936e27,bank_d_00.uk,INCOME,2018-10-03,1200000.00,20000.00,INCOME,Ammy Williams,SAVING
de235ae3-b25f-4612-8251-b450002d09af,bank_d_01.uk,INCOME,2018-10-03,1079688.71,60000.00,INCOME,Ammy Williams,CURRENT
c1e293c5-0829-47be-b3df-57f86bc74551,bank_d_01.uk,RENT,2018-10-03,1059688.71,-20000.00,RENT,Ammy Williams,CURRENT
b453a83c-ae49-411c-b436-e62992ca30bd,bank_d_01.uk,In-N-Out Burger,2018-10-12,1058989.86,-698.85,food,Ammy Williams,CURRENT
4c8a0a8b-1f60-455d-aa75-fefbcb26e540,bank_d_01.uk,In-N-Out Burger,2018-10-21,1058579.76,-410.10,food,Ammy Williams,CURRENT
d29fbc63-9068-47c8-baa0-5f851fe2f09b,bank_d_01.uk,In-N-Out Burger,2018-10-23,1058202.36,-377.40,food,Ammy Williams,CURRENT
b922bc19-299a-4f7f-af99-51cd7bf47ed8,bank_d_01.uk,In-N-Out Burger,2018-10-24,1057543.37,-658.99,food,Ammy Williams,CURRENT
cde9e8ac-4e01-4470-bb15-6fde25ed6a71,bank_d_01.uk,Amazon.com,2018-10-24,1056975.70,-567.67,entertainment,Ammy Williams,CURRENT
0fd90dfb-044b-4673-90c8-a816e76f5f3d,bank_d_01.uk,The Gap,2018-10-25,1055697.29,-1278.41,clothing,Ammy Williams,CURRENT
a58d5357-0cbc-4ed6-a1c8-7879ad349842,bank_d_01.uk,Dr. Martins,2018-10-26,1054481.12,-1216.17,health,Ammy Williams,CURRENT
f43d80ab-ee0c-48ab-b176-f0c5ee0c30a7,bank_d_01.uk,Union 76,2018-10-27,1053399.42,-1081.70,auto,Ammy Williams,CURRENT
d4bb0637-8205-4878-8d1d-e9b1a1958dc9,bank_d_01.uk,Amazon.com,2018-10-27,1053161.02,-238.40,gift,Ammy Williams,CURRENT
12401407-862f-4d47-8281-983f94b3abc8,bank_d_01.uk,In-N-Out Burger,2018-10-28,1052529.87,-631.15,food,Ammy Williams,CURRENT
85e02b81-cf68-4c70-95f1-cf460f49b103,bank_d_01.uk,Amazon.com,2018-10-30,1050926.43,-1603.44,education,Ammy Williams,CURRENT
bab75a1b-8162-4cee-b604-dc5c1ab632cb,bank_d_01.uk,Verizon,2018-11-01,1049498.18,-1428.25,utility,Ammy Williams,CURRENT
1d7c7f55-f983-4ed1-b313-5b85ef29bf3e,bank_d_01.uk,Interest Fee,2018-11-02,1049199.76,-298.42,fee,Ammy Williams,CURRENT
e55a3c2f-030f-4de4-a40a-05e7a5856da6,bank_d_02.uk,INCOME,2018-11-02,791014.56,33000.00,INCOME,Joe Williams,CURRENT
9daba1ea-6d58-4e7c-a911-a875a473ec7e,bank_d_02.uk,Safeway,2018-11-04,790465.89,-548.67,food,Joe Williams,CURRENT
1b5574c0-b57a-4c57-83a3-04dabb51ab55,bank_d_02.uk,Union 76,2018-11-04,789511.46,-954.43,auto,Joe Williams,CURRENT
2ccef4b0-198b-4632-b3bf-ebe22c030671,bank_d_02.uk,Banana Republic,2018-11-09,788150.11,-1361.35,clothing,Joe Williams,CURRENT
d52fec4c-75dd-425f-a0e8-681bb9cb2fc5,bank_d_02.uk,Safeway,2018-11-12,787489.26,-660.85,food,Joe Williams,CURRENT
7ce28aa6-d569-40ba-8b24-77533fbe1a21,bank_d_02.uk,Safeway,2018-11-17,786949.94,-539.32,food,Joe Williams,CURRENT
228c313e-1199-4e52-aa7b-75051d54a480,bank_d_02.uk,Dr. Jackson,2018-11-20,785389.41,-1560.53,health,Joe Williams,CURRENT
5090a6ae-cba4-4b53-bbf0-2f14a5babac3,bank_d_02.uk,Safeway,2018-11-26,785003.32,-386.09,food,Joe Williams,CURRENT
763a076a-f765-40b4-8974-e80a28c59e1a,bank_d_02.uk,iTunes Music Store,2018-11-27,784436.59,-566.73,entertainment,Joe Williams,CURRENT
5d96054d-7af8-46fb-8f06-02f5e4923745,bank_d_02.uk,Neiman-Marcus,2018-11-27,784163.64,-272.95,gift,Joe Williams,CURRENT
eb0c03bf-effb-44d8-9809-75ad95b472dc,bank_d_02.uk,Safeway,2018-12-02,783673.87,-489.77,food,Joe Williams,CURRENT
7b342cfc-d9ff-43fd-9182-120e6df90883,bank_d_02.uk,INCOME,2018-11-02,2930000.00,30000.00,INCOME,Joe Williams,SAVING
00b7dda0-69d8-49ba-b31b-270166d8a2d3,bank_d_00.uk,INCOME,2018-11-02,1220000.00,20000.00,INCOME,Ammy Williams,SAVING
e30516eb-7952-4b80-9eeb-3c91f86c2023,bank_d_01.uk,INCOME,2018-11-02,1109199.76,60000.00,INCOME,Ammy Williams,CURRENT
ab3a3352-4c08-482c-8c3e-6381ea67b6e8,bank_d_01.uk,RENT,2018-11-02,1089199.76,-20000.00,RENT,Ammy Williams,CURRENT
3b0b0d3d-7f56-4f08-b668-3c4bfc604fc9,bank_d_01.uk,Trader Joe's,2018-11-06,1088700.55,-499.21,food,Ammy Williams,CURRENT
59b6fac6-d8c9-4be1-9836-3a980482d83f,bank_d_01.uk,Trader Joe's,2018-11-09,1088000.93,-699.62,food,Ammy Williams,CURRENT
e5c95b30-9389-4738-a3e3-38a5083ef865,bank_d_01.uk,Trader Joe's,2018-11-10,1087652.34,-348.59,food,Ammy Williams,CURRENT
554cdc13-372c-4a39-9377-46b9032e923b,bank_d_01.uk,Amazon.com,2018-11-13,1087223.91,-428.43,entertainment,Ammy Williams,CURRENT
dd712e7f-313c-4738-9204-fd8814a69278,bank_d_01.uk,Monthly Fee,2018-11-19,1086772.97,-450.94,fee,Ammy Williams,CURRENT
f922331f-c0af-4e2f-8356-4891c7a26e2a,bank_d_01.uk,Pep Boys,2018-11-21,1084901.60,-1871.37,auto,Ammy Williams,CURRENT
efe1f3f7-438d-47a4-9d53-ede7a6434825,bank_d_01.uk,Trader Joe's,2018-11-22,1084422.06,-479.54,food,Ammy Williams,CURRENT
36717e7e-8c06-458c-913a-49d830dc66e7,bank_d_01.uk,The Crucible,2018-11-26,1083162.44,-1259.62,education,Ammy Williams,CURRENT
fc72e129-5c84-458e-b2e3-8e7d736d37bc,bank_d_01.uk,PG&E,2018-11-29,1080917.22,-2245.22,utility,Ammy Williams,CURRENT
ff6fec15-758a-446f-b637-d5c968828bf0,bank_d_01.uk,Trader Joe's,2018-11-30,1080464.22,-453.00,food,Ammy Williams,CURRENT
3392eafd-18f9-4b78-8625-1b299ff90119,bank_d_01.uk,Trader Joe's,2018-12-01,1080024.76,-439.46,food,Ammy Williams,CURRENT
4dc976d3-9c5e-4419-af39-ff57abc23c4b,bank_d_01.uk,Kenneth Cole,2018-12-01,1079172.47,-852.29,clothing,Ammy Williams,CURRENT
f5573268-adaa-4643-b87c-c00bb10e2f0e,bank_d_01.uk,Walgreen's,2018-12-02,1077463.26,-1709.21,health,Ammy Williams,CURRENT
e806ff6a-dc52-4bed-9cab-6b9d60278012,bank_d_01.uk,K&L Wines,2018-12-02,1077181.51,-281.75,gift,Ammy Williams,CURRENT
af7fc94c-f4cb-47ae-a258-73f3e783fbf8,bank_d_02.uk,INCOME,2018-12-02,816673.87,33000.00,INCOME,Joe Williams,CURRENT
131bb5a8-1a9d-42cd-bd94-40cdb98452cd,bank_d_02.uk,The Gap,2018-12-02,815102.64,-1571.23,clothing,Joe Williams,CURRENT
61956776-65e0-4017-a64f-5ec5a7d37e0b,bank_d_02.uk,Trader Joe's,2018-12-03,814475.25,-627.39,food,Joe Williams,CURRENT
876ee370-5a58-4530-90eb-8e878843288f,bank_d_02.uk,Union 76,2018-12-05,813140.98,-1334.27,auto,Joe Williams,CURRENT
7db60165-e75b-4c69-a2bf-0dd78d4f9add,bank_d_02.uk,Interest Fee,2018-12-05,812692.72,-448.26,fee,Joe Williams,CURRENT
217436e4-b7cb-4d50-9ed0-e19da0a22572,bank_d_02.uk,Registration,2018-12-08,811435.55,-1257.17,education,Joe Williams,CURRENT
4c5ece2e-e4d2-4077-9f7e-e36127fc8b03,bank_d_02.uk,Trader Joe's,2018-12-09,811100.21,-335.34,food,Joe Williams,CURRENT
20645a27-13e5-4970-a7d3-8d939d7f15d4,bank_d_02.uk,Dr. Martins,2018-12-09,809853.69,-1246.52,health,Joe Williams,CURRENT
ce160ec7-a443-4ae8-beba-9019a40c2a3e,bank_d_02.uk,Trader Joe's,2018-12-10,809434.09,-419.60,food,Joe Williams,CURRENT
e25fa301-9049-4fa3-ad31-9bfd64b30d8c,bank_d_02.uk,AMC Theaters,2018-12-15,808749.92,-684.17,entertainment,Joe Williams,CURRENT
f0006da2-9077-4e80-a4da-eb9548d81709,bank_d_02.uk,Trader Joe's,2018-12-19,808246.22,-503.70,food,Joe Williams,CURRENT
42a7b726-fb8d-4d15-b2be-e130fad540c1,bank_d_02.uk,Trader Joe's,2018-12-20,807617.09,-629.13,food,Joe Williams,CURRENT
1af29e22-74e0-4319-a2c5-cc7428dc7cc1,bank_d_02.uk,Trader Joe's,2018-12-21,807143.69,-473.40,food,Joe Williams,CURRENT
81b56354-63ea-4365-86d3-1338d55af2c7,bank_d_02.uk,Amazon.com,2018-12-23,806890.15,-253.54,gift,Joe Williams,CURRENT
3c879027-53f1-4ea8-8c84-dd07b4edbc2a,bank_d_02.uk,INCOME,2018-12-02,2960000.00,30000.00,INCOME,Joe Williams,SAVING
9ca2e49b-825e-4f6c-9880-12a326207492,bank_d_00.uk,INCOME,2018-12-02,1240000.00,20000.00,INCOME,Ammy Williams,SAVING
8fba3421-3104-4e21-9e2d-4b2b16584982,bank_d_01.uk,INCOME,2018-12-02,1137181.51,60000.00,INCOME,Ammy Williams,CURRENT
ec32c7e1-7942-4a8a-9449-032e11780fae,bank_d_01.uk,Safeway,2018-12-02,1136835.94,-345.57,food,Ammy Williams,CURRENT
f1c2cb34-a6ba-42ec-b3b5-8c5e727cb0aa,bank_d_01.uk,RENT,2018-12-02,1116835.94,-20000.00,RENT,Ammy Williams,CURRENT
5be74748-5d0f-46d8-bd25-60aad49a3bd6,bank_d_01.uk,Safeway,2018-12-04,1116266.06,-569.88,food,Ammy Williams,CURRENT
30c2f480-6218-4c93-a98a-a6ccd53b9e70,bank_d_01.uk,Brinks,2018-12-07,1115071.92,-1194.14,utility,Ammy Williams,CURRENT
a523ec94-ed37-4914-98ce-89632353ecc8,bank_d_01.uk,Shell,2018-12-10,1113726.83,-1345.09,auto,Ammy Williams,CURRENT
91948fd7-7f64-49fd-92c3-5553df5aeefb,bank_d_01.uk,Amazon.com,2018-12-11,1113285.43,-441.40,gift,Ammy Williams,CURRENT
4b441294-bda6-4e89-895c-5e015481547f,bank_d_01.uk,Safeway,2018-12-16,1112581.43,-704.00,food,Ammy Williams,CURRENT
3bce0a26-98a3-4e30-9a0d-6c8eed86eefa,bank_d_01.uk,Safeway,2018-12-23,1112019.58,-561.85,food,Ammy Williams,CURRENT
483af342-ec0c-4100-af8a-504c02d02607,bank_d_01.uk,Netflix,2018-12-24,1111649.16,-370.42,entertainment,Ammy Williams,CURRENT
52311e4a-278b-4c4f-a80b-7e663d077150,bank_d_01.uk,Safeway,2018-12-26,1111300.08,-349.08,food,Ammy Williams,CURRENT
1dfdf7e5-44b1-435d-826b-e06023573652,bank_d_01.uk,Dr. Jackson,2018-12-26,1109585.63,-1714.45,health,Ammy Williams,CURRENT
8a1ca318-6316-436c-ab3b-cc48da98ba5f,bank_d_01.uk,Banana Republic,2018-12-28,1108441.95,-1143.68,clothing,Ammy Williams,CURRENT
cd527f75-a390-4c09-9e60-5cf8b3acfd2f,bank_d_02.uk,INCOME,2019-01-01,839890.15,33000.00,INCOME,Joe Williams,CURRENT
fc428994-6e95-4d0c-93a6-f0944dddaf62,bank_d_02.uk,Safeway,2019-01-05,839191.50,-698.65,food,Joe Williams,CURRENT
6de1d342-2cdf-40ff-b770-df49558cc81e,bank_d_02.uk,AMC Theaters,2019-01-05,838731.54,-459.96,entertainment,Joe Williams,CURRENT
fd748081-5f23-4ff5-9e0a-56c084aade56,bank_d_02.uk,Overlimit Fee,2019-01-07,838204.26,-527.28,fee,Joe Williams,CURRENT
1add33fb-9e65-4d3c-83b1-f5e8a2939664,bank_d_02.uk,Walgreen's,2019-01-13,836886.50,-1317.76,health,Joe Williams,CURRENT
d43dca8f-82d6-4ff3-b419-2570031131e5,bank_d_02.uk,Amazon.com,2019-01-16,836468.17,-418.33,gift,Joe Williams,CURRENT
24d7a31d-df11-4a4a-a20a-19dc2de21c82,bank_d_02.uk,Safeway,2019-01-17,835839.74,-628.43,food,Joe Williams,CURRENT
d5aaaec8-145b-41cf-8c2b-90f5e4bb11b8,bank_d_02.uk,Chevron,2019-01-17,834970.76,-868.98,auto,Joe Williams,CURRENT
2c3e8c7f-f149-477a-86fb-84006ecf6b63,bank_d_02.uk,Safeway,2019-01-20,834447.96,-522.80,food,Joe Williams,CURRENT
5353967a-9fb8-42e0-9367-c598747825f4,bank_d_02.uk,Safeway,2019-01-25,833988.47,-459.49,food,Joe Williams,CURRENT
d858bd40-2a73-481a-988a-848f1c53b0bb,bank_d_02.uk,The Crucible,2019-01-27,832436.18,-1552.29,education,Joe Williams,CURRENT
e2834915-643e-48ee-acb5-027244b693dd,bank_d_02.uk,Macy's,2019-01-30,831410.54,-1025.64,clothing,Joe Williams,CURRENT
6def89c0-0d62-41cc-a320-5eef7d2197e5,bank_d_02.uk,INCOME,2019-01-01,2990000.00,30000.00,INCOME,Joe Williams,SAVING
a0007103-1032-4bb6-afd7-1d2dc65ccf3f,bank_d_00.uk,INCOME,2019-01-01,1260000.00,20000.00,INCOME,Ammy Williams,SAVING
f483e6a8-ded4-4954-968e-fafbcf4de018,bank_d_01.uk,INCOME,2019-01-01,1168441.95,60000.00,INCOME,Ammy Williams,CURRENT
fc0dad6d-4678-489d-9e73-14dbbc80b92c,bank_d_01.uk,RENT,2019-01-01,1148441.95,-20000.00,RENT,Ammy Williams,CURRENT
92726dee-3a87-42f9-ba28-1208c5d22e3d,bank_d_01.uk,Starbucks,2019-01-03,1147869.33,-572.62,food,Ammy Williams,CURRENT
1b44addb-a437-4252-9f29-4115704c3fc6,bank_d_01.uk,Starbucks,2019-01-03,1147521.84,-347.49,food,Ammy Williams,CURRENT
77ed5e9b-be3a-4497-a1f0-89ea46f3699f,bank_d_01.uk,Verizon,2019-01-04,1145222.29,-2299.55,utility,Ammy Williams,CURRENT
234b9a29-1734-4f99-abb0-ef358389fea7,bank_d_01.uk,Apple Store,2019-01-04,1144939.90,-282.39,gift,Ammy Williams,CURRENT
e9c02ced-6eae-4965-aaa7-d5266098c38c,bank_d_01.uk,Starbucks,2019-01-08,1144282.33,-657.57,food,Ammy Williams,CURRENT
403564c6-d688-4c55-87a6-e535421abd19,bank_d_01.uk,Starbucks,2019-01-10,1143975.29,-307.04,food,Ammy Williams,CURRENT
83ebb727-375d-4127-b69e-515c17e77380,bank_d_01.uk,Walgreen's,2019-01-17,1142603.04,-1372.25,health,Ammy Williams,CURRENT
a718321e-35a8-4b33-ba90-22ccf24b3bd5,bank_d_01.uk,Interest Fee,2019-01-24,1142262.40,-340.64,fee,Ammy Williams,CURRENT
d79ec7b8-870f-47b8-a1a6-651f4283cbc3,bank_d_01.uk,Metreon Theaters,2019-01-26,1141541.63,-720.77,entertainment,Ammy Williams,CURRENT
a461a76f-4794-4389-91cd-71d86ab58f7a,bank_d_01.uk,Starbucks,2019-01-27,1140915.99,-625.64,food,Ammy Williams,CURRENT
4bc1084e-eb0a-4678-83b5-212999364351,bank_d_01.uk,Tuition,2019-01-27,1139879.32,-1036.67,education,Ammy Williams,CURRENT
9cfc3eee-4241-4c7b-b98c-1dc29fd70c43,bank_d_01.uk,Macy's,2019-01-31,1138779.83,-1099.49,clothing,Ammy Williams,CURRENT
53f84bbe-041a-4f84-9c5b-d4b35230f2fb,bank_d_02.uk,INCOME,2019-01-31,864410.54,33000.00,INCOME,Joe Williams,CURRENT
d1f75253-5ea2-4a97-8d06-f8fa9dd5a8c7,bank_d_02.uk,Starbucks,2019-01-31,863995.75,-414.79,food,Joe Williams,CURRENT
c944e38d-c1d4-4e4b-a93f-a08f256a6c94,bank_d_02.uk,Nordstrom,2019-01-31,863716.37,-279.38,gift,Joe Williams,CURRENT
4fe36d45-25e8-4f2c-b7c4-39f7a285f610,bank_d_02.uk,PG&E,2019-02-04,861960.30,-1756.07,utility,Joe Williams,CURRENT
9d7ba3b4-9122-41d3-99d0-32480f8317b2,bank_d_02.uk,Banana Republic,2019-02-05,861212.50,-747.80,clothing,Joe Williams,CURRENT
2a01516c-ede2-4027-8bde-ba5360473aeb,bank_d_02.uk,Starbucks,2019-02-10,860856.55,-355.95,food,Joe Williams,CURRENT
ff237743-7205-4e32-b8d7-2af2469cfca6,bank_d_02.uk,Amazon.com,2019-02-13,859764.28,-1092.27,education,Joe Williams,CURRENT
bb7f1f75-e248-4a7c-8aaf-680afb0cd39a,bank_d_02.uk,Starbucks,2019-02-16,859156.18,-608.10,food,Joe Williams,CURRENT
db406628-4c84-4aaa-924a-6bbb22e6f85b,bank_d_02.uk,Netflix,2019-02-21,858754.41,-401.77,entertainment,Joe Williams,CURRENT
7049d5d4-6a9a-4231-bf27-1cd3b0e59be9,bank_d_02.uk,Walgreen's,2019-02-25,857185.53,-1568.88,health,Joe Williams,CURRENT
f971aa5c-1631-4261-8a08-2c195cc252b0,bank_d_02.uk,Starbucks,2019-02-28,856662.18,-523.35,food,Joe Williams,CURRENT
0ac78345-24ee-42f3-96a9-744e0e45c8f6,bank_d_02.uk,Starbucks,2019-02-28,856019.98,-642.20,food,Joe Williams,CURRENT
2438ad98-4beb-4929-bd61-57b4ed089e92,bank_d_02.uk,Chevron,2019-02-28,854627.40,-1392.58,auto,Joe Williams,CURRENT
33a9a03c-291a-4e75-bbe0-647bd899188c,bank_d_02.uk,INCOME,2019-01-31,3020000.00,30000.00,INCOME,Joe Williams,SAVING
bc0a53b2-0505-4fd6-a09a-32bef044bb66,bank_d_00.uk,INCOME,2019-01-31,1280000.00,20000.00,INCOME,Ammy Williams,SAVING
6c90dc92-ed23-462d-a66e-eb70ff768915,bank_d_01.uk,INCOME,2019-01-31,1198779.83,60000.00,INCOME,Ammy Williams,CURRENT
f55ff518-b18c-4de9-8355-b7831cd8fc71,bank_d_01.uk,RENT,2019-01-31,1178779.83,-20000.00,RENT,Ammy Williams,CURRENT
4521352b-ad58-4aac-8b5e-5a5577101b19,bank_d_01.uk,In-N-Out Burger,2019-02-01,1178310.83,-469.00,food,Ammy Williams,CURRENT
828949b9-4869-440e-8677-05bdaaa1c717,bank_d_01.uk,Netflix,2019-02-02,1177574.01,-736.82,entertainment,Ammy Williams,CURRENT
41e07b0a-d3de-4422-a9ee-dd2f1ba4163d,bank_d_01.uk,In-N-Out Burger,2019-02-06,1176936.09,-637.92,food,Ammy Williams,CURRENT
011c8cb2-edc5-4102-a03b-d704ac92be09,bank_d_01.uk,Arco,2019-02-06,1175520.98,-1415.11,auto,Ammy Williams,CURRENT
14895314-d6ad-4b56-a6fd-f39682edbf4d,bank_d_01.uk,Dr. Martins,2019-02-09,1174190.60,-1330.38,health,Ammy Williams,CURRENT
0236fddc-d562-46a3-91e8-4a63d1172dc0,bank_d_01.uk,In-N-Out Burger,2019-02-13,1173791.14,-399.46,food,Ammy Williams,CURRENT
8c269bca-ca22-4544-a229-a00c93d12f81,bank_d_01.uk,In-N-Out Burger,2019-02-15,1173127.92,-663.22,food,Ammy Williams,CURRENT
70405eab-e7fd-4814-b5c1-0dcf36eb2a00,bank_d_01.uk,J. Crew,2019-02-18,1172153.82,-974.10,clothing,Ammy Williams,CURRENT
269fe3c5-fd61-445e-a8aa-ff1e76908a6c,bank_d_01.uk,In-N-Out Burger,2019-02-23,1171541.71,-612.11,food,Ammy Williams,CURRENT
b5903bb3-ee8c-4c1f-9025-c0b66a73d48f,bank_d_01.uk,Brinks,2019-02-24,1169198.74,-2342.97,utility,Ammy Williams,CURRENT
931b7e2e-ffc0-464c-8e5b-c91493fdcd2f,bank_d_01.uk,Apple Store,2019-02-26,1168726.74,-472.00,gift,Ammy Williams,CURRENT
0ef5f217-32c5-4108-b8b9-ecf9b039e8e2,bank_d_01.uk,Registration,2019-03-01,1167105.79,-1620.95,education,Ammy Williams,CURRENT
8e58fccd-f47e-48fb-bd6a-9e29e28776e8,bank_d_02.uk,INCOME,2019-03-02,887627.40,33000.00,INCOME,Joe Williams,CURRENT
98f2b299-e065-4cf2-94bd-653fc752c9bb,bank_d_02.uk,AT&T,2019-03-02,885459.91,-2167.49,utility,Joe Williams,CURRENT
d3cba897-59b0-42c7-bc20-8668d5b9c70e,bank_d_02.uk,Macy's,2019-03-04,884396.81,-1063.10,clothing,Joe Williams,CURRENT
4c99324d-ab27-4b75-a756-d81b36846e8d,bank_d_02.uk,Starbucks,2019-03-06,883896.07,-500.74,food,Joe Williams,CURRENT
31b014d0-528d-4407-bdeb-9346e4a896c2,bank_d_02.uk,Shell,2019-03-08,882777.65,-1118.42,auto,Joe Williams,CURRENT
dd04ccd8-d21e-465f-94c2-69c9fab352b2,bank_d_02.uk,Starbucks,2019-03-15,882376.99,-400.66,food,Joe Williams,CURRENT
fbe7da95-0e72-47db-be78-e5c78794f279,bank_d_02.uk,Dr. Martins,2019-03-16,881312.33,-1064.66,health,Joe Williams,CURRENT
f18ef621-1f1d-4028-8d3c-15292ba0f87a,bank_d_02.uk,iTunes Music Store,2019-03-19,880926.51,-385.82,entertainment,Joe Williams,CURRENT
c9b1c293-3282-4ec4-ac5b-92943d182e7c,bank_d_02.uk,Starbucks,2019-03-22,880392.69,-533.82,food,Joe Williams,CURRENT
d25795cf-fb68-4352-a44d-f5db20164841,bank_d_02.uk,Starbucks,2019-03-23,879823.61,-569.08,food,Joe Williams,CURRENT
cdbc0ac9-f63d-4857-9b6b-c71f5dd59f05,bank_d_02.uk,Starbucks,2019-03-28,879273.02,-550.59,food,Joe Williams,CURRENT
86de62e8-e519-40fc-a53d-87f1022818bf,bank_d_02.uk,Starbucks,2019-03-28,878917.24,-355.78,food,Joe Williams,CURRENT
fd2a0295-0b55-48d2-8204-418d21af912a,bank_d_02.uk,K&L Wines,2019-04-01,878600.72,-316.52,gift,Joe Williams,CURRENT
f3fcf569-2faf-443e-bcda-8ad2d43878ca,bank_d_02.uk,Tuition,2019-04-01,877644.81,-955.91,education,Joe Williams,CURRENT
f3f40c9d-4584-4805-a060-a80a7971da00,bank_d_02.uk,INCOME,2019-03-02,3050000.00,30000.00,INCOME,Joe Williams,SAVING
1e69d300-242c-4291-bab2-ae574f14ac38,bank_d_00.uk,INCOME,2019-03-02,1300000.00,20000.00,INCOME,Ammy Williams,SAVING
857bd080-6a33-4475-9df3-4b150915d8a8,bank_d_01.uk,INCOME,2019-03-02,1227105.79,60000.00,INCOME,Ammy Williams,CURRENT
3997528b-b30c-4ab8-9ba5-66beb8c265a1,bank_d_01.uk,RENT,2019-03-02,1207105.79,-20000.00,RENT,Ammy Williams,CURRENT
635875e0-567d-4d6f-8376-f086290514e1,bank_d_01.uk,AT&T,2019-03-03,1204678.16,-2427.63,utility,Ammy Williams,CURRENT
376148fc-19b3-43af-ae56-bf2ba9f35e01,bank_d_01.uk,Safeway,2019-03-04,1204359.22,-318.94,food,Ammy Williams,CURRENT
51c13504-249a-4c73-a41f-94c474055687,bank_d_01.uk,Safeway,2019-03-09,1203949.26,-409.96,food,Ammy Williams,CURRENT
84c76425-5f37-4179-ab87-6e12e55f1150,bank_d_01.uk,Safeway,2019-03-10,1203488.49,-460.77,food,Ammy Williams,CURRENT
71f9eaf4-31cd-4c80-b353-18b06a7d2333,bank_d_01.uk,Safeway,2019-03-17,1202944.19,-544.30,food,Ammy Williams,CURRENT
e95bad61-1004-4122-a319-60d9d7be708a,bank_d_01.uk,Campus Books,2019-03-21,1201571.81,-1372.38,education,Ammy Williams,CURRENT
473da468-cb46-4012-8925-1fa774ac223a,bank_d_01.uk,Nordstrom,2019-03-22,1200446.46,-1125.35,clothing,Ammy Williams,CURRENT
6ba3b28b-644b-481b-be58-fe4b62387367,bank_d_01.uk,Shell,2019-03-22,1198552.23,-1894.23,auto,Ammy Williams,CURRENT
41749092-7c08-4223-bcdc-d93b39f383d4,bank_d_01.uk,Apple Store,2019-03-26,1198235.09,-317.14,gift,Ammy Williams,CURRENT
60d02dcd-67a9-49c3-b893-b37783e9c74b,bank_d_01.uk,Rhapsody,2019-03-28,1197758.60,-476.49,entertainment,Ammy Williams,CURRENT
5711dad2-1341-4b7f-9719-1c20075b0807,bank_d_01.uk,Dr. Martins,2019-03-31,1195971.48,-1787.12,health,Ammy Williams,CURRENT
976dccfa-ce49-4a1d-904c-bda3d32af843,bank_d_02.uk,INCOME,2019-04-01,910644.81,33000.00,INCOME,Joe Williams,CURRENT
334b8060-bc9d-4d91-a031-729ee1a489ab,bank_d_02.uk,Campus Books,2019-04-01,908975.29,-1669.52,education,Joe Williams,CURRENT
a125e346-aa07-49cd-904f-d5bfebce8f39,bank_d_02.uk,Whole Foods,2019-04-04,908414.95,-560.34,food,Joe Williams,CURRENT
a1a2aab1-7875-49e5-ac62-d96ac7ade0e1,bank_d_02.uk,Nordstrom,2019-04-05,907679.61,-735.34,clothing,Joe Williams,CURRENT
1ad22c46-c1d1-4e7a-b1de-1974275fc1d9,bank_d_02.uk,Whole Foods,2019-04-10,907053.08,-626.53,food,Joe Williams,CURRENT
08ff401b-fbe8-4e5f-80a2-94377481ff99,bank_d_02.uk,Nordstrom,2019-04-11,906683.80,-369.28,gift,Joe Williams,CURRENT
4f9baed5-8a14-49af-8e62-9ad36118ede0,bank_d_02.uk,Whole Foods,2019-04-13,906288.29,-395.51,food,Joe Williams,CURRENT
46b1fe0e-818a-4750-bb5a-6b6c059a524f,bank_d_02.uk,Whole Foods,2019-04-14,905733.00,-555.29,food,Joe Williams,CURRENT
48b07dd7-157a-4422-a72b-4c7f188f49fa,bank_d_02.uk,Comcast,2019-04-14,903579.45,-2153.55,utility,Joe Williams,CURRENT
890e560a-c2f6-4f13-8eec-ec580825f57b,bank_d_02.uk,Walgreen's,2019-04-16,902384.94,-1194.51,health,Joe Williams,CURRENT
8c1e5ab0-ffa1-4a80-917c-2d1c8a6a56a8,bank_d_02.uk,Metreon Theaters,2019-04-21,901894.82,-490.12,entertainment,Joe Williams,CURRENT
3a984443-6ba0-46f3-82e6-bbef06e52e79,bank_d_02.uk,Whole Foods,2019-04-24,901364.64,-530.18,food,Joe Williams,CURRENT
60eb54b8-c2f5-4953-b0de-5c8a94f5323f,bank_d_02.uk,Bank Fee,2019-04-29,901069.76,-294.88,fee,Joe Williams,CURRENT
55a63da7-6290-4042-b71a-029e6837f987,bank_d_02.uk,INCOME,2019-04-01,3080000.00,30000.00,INCOME,Joe Williams,SAVING
ce619b56-5135-4d6a-8a8e-fdf33c1f5441,bank_d_00.uk,INCOME,2019-04-01,1320000.00,20000.00,INCOME,Ammy Williams,SAVING
a0fdfe01-62e7-4481-8c13-62b26732c6f7,bank_d_01.uk,INCOME,2019-04-01,1255971.48,60000.00,INCOME,Ammy Williams,CURRENT
43435bc1-fad1-4ea9-82d3-8d25125e102c,bank_d_01.uk,RENT,2019-04-01,1235971.48,-20000.00,RENT,Ammy Williams,CURRENT
825b68ef-ce3b-4b8b-a5c9-b908d509b9d5,bank_d_01.uk,Amazon.com,2019-04-03,1235536.68,-434.80,entertainment,Ammy Williams,CURRENT
445f1608-39d2-445f-86a3-cada533c5c9d,bank_d_01.uk,Olive Garden,2019-04-06,1234977.12,-559.56,food,Ammy Williams,CURRENT
e158c65e-8a57-4cdd-8d51-35e426bd031c,bank_d_01.uk,Olive Garden,2019-04-12,1234426.07,-551.05,food,Ammy Williams,CURRENT
1960a5ab-e7b2-4991-9b57-7837c2720783,bank_d_01.uk,Olive Garden,2019-04-13,1233900.24,-525.83,food,Ammy Williams,CURRENT
7de3cdaa-c3c1-497f-a17e-3f81a0dde321,bank_d_01.uk,Olive Garden,2019-04-14,1233433.07,-467.17,food,Ammy Williams,CURRENT
2b501dbf-df70-4f57-a56d-515c21a663b8,bank_d_01.uk,PG&E,2019-04-16,1231670.34,-1762.73,utility,Ammy Williams,CURRENT
6db31b8b-eb59-4d4c-aff1-2e93feaa423e,bank_d_01.uk,Dr. Martins,2019-04-16,1229638.01,-2032.33,health,Ammy Williams,CURRENT
688a2922-440b-46c0-9799-d87cb6343fb1,bank_d_01.uk,K&L Wines,2019-04-20,1229133.10,-504.91,gift,Ammy Williams,CURRENT
185913da-fbf3-42a6-b606-e4052c47b613,bank_d_01.uk,Olive Garden,2019-04-23,1228538.56,-594.54,food,Ammy Williams,CURRENT
152595b5-a267-4624-9298-d430210eb98d,bank_d_01.uk,Amazon.com,2019-04-25,1227223.21,-1315.35,education,Ammy Williams,CURRENT
4fc0bf11-abe3-4381-be85-64751658d2e8,bank_d_01.uk,Kenneth Cole,2019-04-29,1226308.72,-914.49,clothing,Ammy Williams,CURRENT
