id,bank,counterparty,posted,new_balance,value,type,user,account_type
760d7dc3-70bc-4238-87de-c88cced3f780,bank_a_00.uk,INCOME,2016-05-12,93000.00,33000.00,INCOME,John Smith,CURRENT
cebf8b46-3f3b-4e73-b365-23ad3f7994d3,bank_a_00.uk,Whole Foods,2016-05-12,92496.01,-503.99,food,John Smith,CURRENT
5086bffb-e04d-4fa4-8aac-6984053d1794,bank_a_00.uk,Whole Foods,2016-05-13,92064.09,-431.92,food,John Smith,CURRENT
130de252-7699-4d90-aa50-701cdc23295d,bank_a_00.uk,Whole Foods,2016-05-15,91430.56,-633.53,food,John Smith,CURRENT
94b19e3c-8c0d-4375-8168-2700f576fb5e,bank_a_00.uk,Monthly Fee,2016-05-20,90942.45,-488.11,fee,John Smith,CURRENT
e9b9300c-3bd8-4f95-aae6-ec08a439e3ff,bank_a_00.uk,Whole Foods,2016-05-24,90338.40,-604.05,food,John Smith,CURRENT
11ddac56-256e-410b-ac46-36520fcb1057,bank_a_00.uk,Tuition,2016-05-29,88854.06,-1484.34,education,John Smith,CURRENT
e0afd5bb-7e44-4637-87bc-cdb7167c23fe,bank_a_00.uk,Whole Foods,2016-05-31,88320.87,-533.19,food,John Smith,CURRENT
a89b76b3-e1b9-4e4c-b969-01d8de245efe,bank_a_00.uk,Netflix,2016-06-03,87858.14,-462.73,entertainment,John Smith,CURRENT
dc57ecbd-609e-491b-8a4b-92a71ba4a004,bank_a_00.uk,K&L Wines,2016-06-04,87349.58,-508.56,gift,John Smith,CURRENT
5425e490-a473-47f3-b689-7cfe7a74b9bc,bank_a_00.uk,PG&E,2016-06-05,86166.76,-1182.82,utility,John Smith,CURRENT
c22f5c12-19cb-4577-bf6c-f57bd73a9992,bank_a_00.uk,Kenneth Cole,2016-06-05,84542.80,-1623.96,clothing,John Smith,CURRENT
590de58e-42a4-4342-845d-f7c23dbf92e5,bank_a_00.uk,Whole Foods,2016-06-06,84089.69,-453.11,food,John Smith,CURRENT
86882c63-387d-438a-8103-6e6b6ccf313d,bank_a_00.uk,Wal-Mart,2016-06-09,82790.64,-1299.05,health,John Smith,CURRENT
40803023-1ad1-4535-af75-12997297bc83,bank_a_02.uk,INCOME,2016-05-12,2030000.00,30000.00,INCOME,John Smith,SAVING
6f148687-1240-48af-bb0d-b76bdc3c129c,bank_a_00.uk,INCOME,2016-05-12,620000.00,20000.00,INCOME,Alice Johnson,SAVING
0fbd2f4b-e5cc-4b90-bb7d-703c6afdca1f,bank_a_00.uk,INCOME,2016-05-12,210000.00,60000.00,INCOME,Alice Johnson,CURRENT
0781a543-692b-43fe-a8b0-45a3500cea1a,bank_a_00.uk,RENT,2016-05-12,190000.00,-20000.00,RENT,Alice Johnson,CURRENT
95bf77bf-d188-4878-9ad4-d8f3acd2b2f9,bank_a_00.uk,Tuition,2016-05-16,189180.36,-819.64,education,Alice Johnson,CURRENT
e777a30d-ff3d-4c41-9a34-7651d3040708,bank_a_00.uk,Olive Garden,2016-05-18,188679.06,-501.30,food,Alice Johnson,CURRENT
afcafd01-0e77-49d8-9764-765466d901ee,bank_a_00.uk,Olive Garden,2016-05-21,188130.08,-548.98,food,Alice Johnson,CURRENT
b9fe4a6a-2749-4f88-a658-018e853b298e,bank_a_00.uk,Olive Garden,2016-05-25,187764.30,-365.78,food,Alice Johnson,CURRENT
c7dafc00-1179-44b9-bd3c-fc6092ef2250,bank_a_00.uk,Olive Garden,2016-05-27,187321.79,-442.51,food,Alice Johnson,CURRENT
c2e1edd5-a11f-49b6-88c3-14c96a8425ce,bank_a_00.uk,Rhapsody,2016-05-27,186857.91,-463.88,entertainment,Alice Johnson,CURRENT
72fe7b16-6317-41a7-9f02-e0d09b9551a3,bank_a_00.uk,Olive Garden,2016-06-01,186186.98,-670.93,food,Alice Johnson,CURRENT
a5b4c0ed-9063-4cac-947f-e89c163e9c7d,bank_a_00.uk,Banana Republic,2016-06-05,184952.69,-1234.29,clothing,Alice Johnson,CURRENT
4d95feb4-29a7-4b21-9f38-c651ae17c1a3,bank_a_00.uk,Brinks,2016-06-08,182589.70,-2362.99,utility,Alice Johnson,CURRENT
610bf19e-e11b-48bf-b1ec-90be4bf166b7,bank_a_00.uk,Olive Garden,2016-06-11,181900.69,-689.01,food,Alice Johnson,CURRENT
9e14853e-4250-4bfc-a81e-b761bc81b193,bank_a_00.uk,Walgreen's,2016-06-11,180898.00,-1002.69,health,Alice Johnson,CURRENT
097ed131-b4ea-4839-b796-441e480e9b06,bank_a_00.uk,INCOME,2016-06-11,115790.64,33000.00,INCOME,John Smith,CURRENT
7584f659-c028-430a-a2d3-33d616d1b414,bank_a_00.uk,Amazon.com,2016-06-18,115271.42,-519.22,gift,John Smith,CURRENT
1fbd6505-d498-4b08-8040-8bf13aa3bffb,bank_a_00.uk,Starbucks,2016-06-22,114692.89,-578.53,food,John Smith,CURRENT
1e757d6b-c9b8-461b-89e0-f6128327e587,bank_a_00.uk,Starbucks,2016-06-23,114105.17,-587.72,food,John Smith,CURRENT
05b32fa4-858f-4622-b28f-4e2350d34ace,bank_a_00.uk,Starbucks,2016-06-23,113581.72,-523.45,food,John Smith,CURRENT
0cc59d28-028c-4826-a751-a45d24d207f4,bank_a_00.uk,Starbucks,2016-06-25,113113.09,-468.63,food,John Smith,CURRENT
1d5d30d3-81e4-4cac-90a3-03d9f623bfd8,bank_a_00.uk,Starbucks,2016-06-29,112754.53,-358.56,food,John Smith,CURRENT
4ce4c78b-7773-48ee-be39-e12db8dc5172,bank_a_00.uk,Campus Books,2016-06-30,111912.52,-842.01,education,John Smith,CURRENT
b99ae8a3-eb9f-4bc9-bcf8-00925c3be62d,bank_a_00.uk,Starbucks,2016-07-02,111577.82,-334.70,food,John Smith,CURRENT
5b951117-0d14-49b2-8f9f-54de98127825,bank_a_00.uk,The Gap,2016-07-07,109981.77,-1596.05,clothing,John Smith,CURRENT
05bad7e1-0823-49ff-a6e7-e6093c3b17a3,bank_a_00.uk,Dr. Martins,2016-07-09,108675.01,-1306.76,health,John Smith,CURRENT
986a6765-7802-441d-852a-1b508d7bc178,bank_a_00.uk,Metreon Theaters,2016-07-10,108197.65,-477.36,entertainment,John Smith,CURRENT
412aaa29-ec3e-44c8-98f3-461367108daf,bank_a_00.uk,Brinks,2016-07-11,106198.46,-1999.19,utility,John Smith,CURRENT
5327b076-3352-4269-a09c-f882270a4d77,bank_a_02.uk,INCOME,2016-06-11,2060000.00,30000.00,INCOME,John Smith,SAVING
65ef7acf-10d1-4d0d-85fc-dcb200762b97,bank_a_00.uk,INCOME,2016-06-11,640000.00,20000.00,INCOME,Alice Johnson,SAVING
9256b182-0438-4a87-8746-f72f36f904b2,bank_a_00.uk,INCOME,2016-06-11,240898.00,60000.00,INCOME,Alice Johnson,CURRENT
780b75ba-0092-47f9-923b-750e96f021be,bank_a_00.uk,RENT,2016-06-11,220898.00,-20000.00,RENT,Alice Johnson,CURRENT
2d71fb28-0ce5-43b8-8d42-db7f63b1e86c,bank_a_00.uk,Nordstrom,2016-06-12,220189.71,-708.29,clothing,Alice Johnson,CURRENT
bbf19b56-7796-4e45-9c37-952fb4f05e72,bank_a_00.uk,Apple Store,2016-06-13,219779.79,-409.92,gift,Alice Johnson,CURRENT
2c32aba5-fd61-43f0-8833-da5d3bdbd6c4,bank_a_00.uk,Monthly Fee,2016-06-16,219491.02,-288.77,fee,Alice Johnson,CURRENT
94a972fe-5fd9-47c8-be71-a15f46955c21,bank_a_00.uk,Olive Garden,2016-06-21,219057.57,-433.45,food,Alice Johnson,CURRENT
84ed65b0-0071-43e7-9c91-b04ad4a3da56,bank_a_00.uk,Dr. Martins,2016-06-22,218156.33,-901.24,health,Alice Johnson,CURRENT
74035ef0-42d2-4fcd-96ff-208aa6ea26dc,bank_a_00.uk,Rhapsody,2016-06-25,217346.70,-809.63,entertainment,Alice Johnson,CURRENT
6e9aff45-320d-4719-8844-c852523dc0f4,bank_a_00.uk,Olive Garden,2016-06-26,216789.67,-557.03,food,Alice Johnson,CURRENT
903821df-cfef-434a-90fd-d4913def0264,bank_a_00.uk,Brinks,2016-06-28,214262.48,-2527.19,utility,Alice Johnson,CURRENT
8682f74d-aa9a-4a33-841d-9ceb563491fa,bank_a_00.uk,Olive Garden,2016-06-29,213644.47,-618.01,food,Alice Johnson,CURRENT
8a464d9f-5c0d-4b88-b4cf-36ca608eeb61,bank_a_00.uk,Campus Books,2016-07-02,212546.44,-1098.03,education,Alice Johnson,CURRENT
e27e0325-71fa-44bc-ab0f-5ec7e8e093db,bank_a_00.uk,Olive Garden,2016-07-05,211978.72,-567.72,food,Alice Johnson,CURRENT
5b55c0bc-1b68-48a9-964f-d366376336bb,bank_a_00.uk,Union 76,2016-07-06,211110.53,-868.19,auto,Alice Johnson,CURRENT
2cc5bd03-ae00-40d4-8e59-648b3f97cbe1,bank_a_00.uk,INCOME,2016-07-11,139198.46,33000.00,INCOME,John Smith,CURRENT
fa29122e-3273-411c-beda-ea4c9e8829c1,bank_a_00.uk,Walgreen's,2016-07-11,137362.67,-1835.79,health,John Smith,CURRENT
dd722347-23d5-4528-ae3b-1cbe2bd3bb32,bank_a_00.uk,Chevron,2016-07-15,136156.30,-1206.37,auto,John Smith,CURRENT
01dbf5f7-b9a7-4e75-9f36-4f921f47461c,bank_a_00.uk,Metreon Theaters,2016-07-20,135380.42,-775.88,entertainment,John Smith,CURRENT
0bce8b38-2d00-4a87-9a6a-91e57ca1fe41,bank_a_00.uk,Nordstrom,2016-07-25,134902.32,-478.10,gift,John Smith,CURRENT
9bb15c20-b13e-44ce-8e78-80ae582b4fa2,bank_a_00.uk,Trader Joe's,2016-07-26,134333.67,-568.65,food,John Smith,CURRENT
b8e6bc9d-ec4b-43c7-9a60-b652fde404f6,bank_a_00.uk,Trader Joe's,2016-07-27,133988.39,-345.28,food,John Smith,CURRENT
9994e195-caaf-48a8-a139-6bfd0a50e2ab,bank_a_00.uk,Trader Joe's,2016-07-28,133660.07,-328.32,food,John Smith,CURRENT
4cf13dbc-453e-4125-ba96-79fa686068f9,bank_a_00.uk,Trader Joe's,2016-07-28,133343.84,-316.23,food,John Smith,CURRENT
e5d57fa4-85a2-4cd7-8027-99aaf9304f46,bank_a_00.uk,Trader Joe's,2016-07-29,133013.47,-330.37,food,John Smith,CURRENT
43d157f5-a063-4eed-83a4-07700062534d,bank_a_00.uk,Brinks,2016-07-31,131729.15,-1284.32,utility,John Smith,CURRENT
eb527d7e-7fb2-45d1-8662-e4248ffe5ab0,bank_a_00.uk,The Crucible,2016-08-07,130563.06,-1166.09,education,John Smith,CURRENT
1e67fafc-9eb3-47e2-acd7-84c99186535a,bank_a_00.uk,Macy's,2016-08-08,129645.84,-917.22,clothing,John Smith,CURRENT
60db7f10-9e08-44b8-bbef-d2f4d2bac81f,bank_a_00.uk,Overlimit Fee,2016-08-08,129272.21,-373.63,fee,John Smith,CURRENT
af449c8f-531e-45d6-85a1-54732e5b6b5b,bank_a_00.uk,Trader Joe's,2016-08-10,128896.65,-375.56,food,John Smith,CURRENT
e5646600-5ad7-4c15-b09f-b9d95c4dcf78,bank_a_02.uk,INCOME,2016-07-11,2090000.00,30000.00,INCOME,John Smith,SAVING
8987e89e-fac6-4965-b69f-ee12a4cbd3ff,bank_a_00.uk,INCOME,2016-07-11,660000.00,20000.00,INCOME,Alice Johnson,SAVING
e3dc22af-f6e5-4f7b-ad12-5e376a7d0dd3,bank_a_00.uk,INCOME,2016-07-11,271110.53,60000.00,INCOME,Alice Johnson,CURRENT
9f04af2d-beae-4b82-a0b7-aed73f1365b3,bank_a_00.uk,RENT,2016-07-11,251110.53,-20000.00,RENT,Alice Johnson,CURRENT
93574263-cf21-4f9b-9c0f-5b58d27c8df4,bank_a_00.uk,AMC Theaters,2016-07-17,250536.86,-573.67,entertainment,Alice Johnson,CURRENT
a29a7038-acb9-4e4e-80f5-373f536c09af,bank_a_00.uk,Olive Garden,2016-07-18,250169.19,-367.67,food,Alice Johnson,CURRENT
8298cabc-270f-4ec8-948f-471ec5e7561d,bank_a_00.uk,Olive Garden,2016-07-20,249639.08,-530.11,food,Alice Johnson,CURRENT
40775650-2c90-45ad-be1d-97fa3a643e0f,bank_a_00.uk,Olive Garden,2016-07-25,249221.66,-417.42,food,Alice Johnson,CURRENT
56038464-3b17-4e21-b65b-f7530f2ed469,bank_a_00.uk,Olive Garden,2016-07-25,248546.89,-674.77,food,Alice Johnson,CURRENT
7143ecc5-111a-47cf-a4b0-474cce057b6f,bank_a_00.uk,Overlimit Fee,2016-07-27,248220.62,-326.27,fee,Alice Johnson,CURRENT
c7251e49-335b-4a9c-92fc-a29ae9e94014,bank_a_00.uk,Olive Garden,2016-08-03,247765.79,-454.83,food,Alice Johnson,CURRENT
c72a7f32-f34c-4b57-adcd-e39bc536986c,bank_a_00.uk,Macy's,2016-08-03,246540.30,-1225.49,clothing,Alice Johnson,CURRENT
3cba79ad-3e7c-47c3-b6be-5bf61cddac25,bank_a_00.uk,Pep Boys,2016-08-04,244725.12,-1815.18,auto,Alice Johnson,CURRENT
f0ca62f6-9e8d-4697-b6c0-156440424415,bank_a_00.uk,Tuition,2016-08-04,243413.48,-1311.64,education,Alice Johnson,CURRENT
33ebeb38-17ca-4de6-ada2-c9bb2374679d,bank_a_00.uk,Walgreen's,2016-08-05,241998.47,-1415.01,health,Alice Johnson,CURRENT
0f8bf393-6531-49c0-9522-0f5a09b69247,bank_a_00.uk,,2016-08-06,240460.45,-1538.02,utility,Alice Johnson,CURRENT
89e4eca6-96b8-4faf-a394-0a37251354b0,bank_a_00.uk,INCOME,2016-08-10,161896.65,33000.00,INCOME,John Smith,CURRENT
8f17348d-8b9b-47c2-8ed0-cb1aee58e894,bank_a_00.uk,Nordstrom,2016-08-10,160472.38,-1424.27,clothing,John Smith,CURRENT
c25e5efb-fff6-44da-b07c-22731cf9cc2f,bank_a_00.uk,Rhapsody,2016-08-16,159910.37,-562.01,entertainment,John Smith,CURRENT
e02c2cb3-e405-4668-a8cc-11068580c68f,bank_a_00.uk,Amazon.com,2016-08-22,159045.63,-864.74,education,John Smith,CURRENT
e8b53a3b-766c-49a3-8ced-8933c71e5dfc,bank_a_00.uk,Walgreen's,2016-08-25,157137.57,-1908.06,health,John Smith,CURRENT
6c0da0f5-766c-4387-8de0-55f937b618eb,bank_a_00.uk,Whole Foods,2016-08-27,156558.73,-578.84,food,John Smith,CURRENT
6100a19c-05d9-4975-a0ea-edfc4a20e0d7,bank_a_00.uk,Whole Foods,2016-08-27,156113.73,-445.00,food,John Smith,CURRENT
20d585b1-75bf-449f-8e78-569965985e62,bank_a_00.uk,Whole Foods,2016-08-28,155760.69,-353.04,food,John Smith,CURRENT
9a84e10b-1de4-49a4-8c81-c44a03b5edc5,bank_a_00.uk,Whole Foods,2016-08-28,155451.15,-309.54,food,John Smith,CURRENT
c2a6e575-d31f-46a8-b54b-2acf25165763,bank_a_00.uk,,2016-08-28,153281.16,-2169.99,utility,John Smith,CURRENT
9cb47cd3-6acf-4231-9201-8202820dac51,bank_a_00.uk,Whole Foods,2016-08-30,152645.39,-635.77,food,John Smith,CURRENT
c17d44b3-4fe6-4b68-9031-a71d86fbe27b,bank_a_00.uk,Whole Foods,2016-09-07,152065.09,-580.30,food,John Smith,CURRENT
0f8fc263-6e4a-44c6-ace6-b0be15067909,bank_a_00.uk,Nordstrom,2016-09-07,151758.19,-306.90,gift,John Smith,CURRENT
f5c71c46-2b08-42d4-a5a4-656b2a258b93,bank_a_02.uk,INCOME,2016-08-10,2120000.00,30000.00,INCOME,John Smith,SAVING
a96f839e-ddaf-448a-bd91-c9a8c8f018fd,bank_a_00.uk,INCOME,2016-08-10,680000.00,20000.00,INCOME,Alice Johnson,SAVING
52253e92-4b7b-40e0-ba51-423b1a6ed31e,bank_a_00.uk,INCOME,2016-08-10,300460.45,60000.00,INCOME,Alice Johnson,CURRENT
9c84e1d4-ced3-4d1b-8d26-dc771ea7d433,bank_a_00.uk,RENT,2016-08-10,280460.45,-20000.00,RENT,Alice Johnson,CURRENT
e134c1a0-bb49-43ef-8d21-5816a175586b,bank_a_00.uk,Safeway,2016-08-12,279850.51,-609.94,food,Alice Johnson,CURRENT
681f5e05-f5a7-44df-bac6-7de779a43b9a,bank_a_00.uk,Safeway,2016-08-12,279243.49,-607.02,food,Alice Johnson,CURRENT
0cf10ef9-f01d-4cec-9533-75410ccc2d01,bank_a_00.uk,Safeway,2016-08-16,278779.53,-463.96,food,Alice Johnson,CURRENT
680f057a-14d4-45b2-a8b2-f782554de77c,bank_a_00.uk,Annual Fee,2016-08-18,278249.10,-530.43,fee,Alice Johnson,CURRENT
41b3aa3a-98fc-45fb-94f4-a2093f5401cf,bank_a_00.uk,Metreon Theaters,2016-08-20,277651.55,-597.55,entertainment,Alice Johnson,CURRENT
8c91c94f-d9b3-41c6-bd4e-3fb10be39360,bank_a_00.uk,Arco,2016-08-23,276337.41,-1314.14,auto,Alice Johnson,CURRENT
43731fd5-cb83-4690-acb5-092095b197a1,bank_a_00.uk,Safeway,2016-08-29,275825.45,-511.96,food,Alice Johnson,CURRENT
9f949788-b3ac-4e29-a4fe-f35dad353b93,bank_a_00.uk,PG&E,2016-08-29,273414.08,-2411.37,utility,Alice Johnson,CURRENT
fd6b4a48-1c5f-451b-9ec0-79e1763b915a,bank_a_00.uk,Dr. Roberts,2016-08-29,272302.48,-1111.60,health,Alice Johnson,CURRENT
6ed7ebc1-f366-4f0c-9390-50e45b65cca4,bank_a_00.uk,Safeway,2016-09-06,271944.04,-358.44,food,Alice Johnson,CURRENT
f434052e-dc18-4cbb-9def-df6adc26e1dd,bank_a_00.uk,J. Crew,2016-09-08,270473.64,-1470.40,clothing,Alice Johnson,CURRENT
69d3842b-9c9a-4505-92ef-48a3fca13d4b,bank_a_00.uk,Tuition,2016-09-09,268824.92,-1648.72,education,Alice Johnson,CURRENT
a619c433-a70f-4a49-8e79-69b73b7b4e0c,bank_a_00.uk,INCOME,2016-09-09,184758.19,33000.00,INCOME,John Smith,CURRENT
2d68594f-ff40-466e-ac0e-5a88368d90f0,bank_a_00.uk,Amazon.com,2016-09-11,184364.20,-393.99,entertainment,John Smith,CURRENT
6a4f6e99-98de-49c8-9d73-b3fa5f0c789b,bank_a_00.uk,Nordstrom,2016-09-16,183911.07,-453.13,gift,John Smith,CURRENT
cdd84604-40f4-43da-96ae-090292b05636,bank_a_00.uk,Trader Joe's,2016-09-17,183248.57,-662.50,food,John Smith,CURRENT
478f1bff-582c-452e-907a-fb975c77825b,bank_a_00.uk,Tuition,2016-09-21,181790.07,-1458.50,education,John Smith,CURRENT
53c1d458-b5fb-4f75-b3de-29df48f8c24e,bank_a_00.uk,Trader Joe's,2016-09-23,181252.85,-537.22,food,John Smith,CURRENT
04816147-1a37-4850-baf6-5f5f30f8b9aa,bank_a_00.uk,Trader Joe's,2016-10-02,180891.72,-361.13,food,John Smith,CURRENT
a2699c94-ea78-4793-a030-de55a0477460,bank_a_00.uk,J. Crew,2016-10-02,179939.28,-952.44,clothing,John Smith,CURRENT
143c5383-1be0-4fe5-ac04-42c00a21808d,bank_a_00.uk,Trader Joe's,2016-10-04,179333.80,-605.48,food,John Smith,CURRENT
ca93182f-2b4f-4806-99e3-d5bf893532b5,bank_a_00.uk,Jiffy Lube,2016-10-04,178286.26,-1047.54,auto,John Smith,CURRENT
a798c8da-9da5-4ae3-ae0f-3ebb19172883,bank_a_00.uk,Wal-Mart,2016-10-06,176816.82,-1469.44,health,John Smith,CURRENT
ebfec57c-d4d8-48c3-9c0f-8383a1ea86ab,bank_a_02.uk,INCOME,2016-09-09,2150000.00,30000.00,INCOME,John Smith,SAVING
036253a6-bc75-4dbc-bf00-52aa795c2f98,bank_a_00.uk,INCOME,2016-09-09,700000.00,20000.00,INCOME,Alice Johnson,SAVING
355fc6ae-4a12-44a2-a1c6-b18fb54c04ff,bank_a_00.uk,INCOME,2016-09-09,328824.92,60000.00,INCOME,Alice Johnson,CURRENT
c32676c4-7706-4a77-a778-4e17b98455f5,bank_a_00.uk,RENT,2016-09-09,308824.92,-20000.00,RENT,Alice Johnson,CURRENT
702e961f-2e90-4b69-9ec9-43f174f09056,bank_a_00.uk,Safeway,2016-09-16,308305.76,-519.16,food,Alice Johnson,CURRENT
59057d5f-5cec-4a37-abb4-04334e1885a2,bank_a_00.uk,Safeway,2016-09-23,307878.86,-426.90,food,Alice Johnson,CURRENT
2c7be5f1-8ab1-4358-948a-9e59d43e3f37,bank_a_00.uk,Verizon,2016-09-24,305354.18,-2524.68,utility,Alice Johnson,CURRENT
fab8a276-b472-4b90-8ec5-0b184df6c126,bank_a_00.uk,Wal-Mart,2016-10-02,303972.37,-1381.81,health,Alice Johnson,CURRENT
82d10acf-bcf3-4cba-97e5-24c52f315c2a,bank_a_00.uk,Safeway,2016-10-04,303326.70,-645.67,food,Alice Johnson,CURRENT
21ecac3e-15be-4091-ab03-737dea6b41a3,bank_a_00.uk,Safeway,2016-10-07,302799.01,-527.69,food,Alice Johnson,CURRENT
6654a946-1eb0-44ad-aeae-683de99c252c,bank_a_00.uk,Kenneth Cole,2016-10-07,301293.01,-1506.00,clothing,Alice Johnson,CURRENT
38861c4d-6fd7-455d-9abd-b3fb9e2a702b,bank_a_00.uk,Union 76,2016-10-07,299956.74,-1336.27,auto,Alice Johnson,CURRENT
3995d54a-6e97-4e1b-9f20-d8f264dd4c00,bank_a_00.uk,Campus Books,2016-10-07,298286.92,-1669.82,education,Alice Johnson,CURRENT
bf7b4418-0184-4e18-86ef-38deeb30f767,bank_a_00.uk,Monthly Fee,2016-10-07,297985.42,-301.50,fee,Alice Johnson,CURRENT
9bae5557-ff43-4aec-8f1a-bb65851c7fea,bank_a_00.uk,iTunes Music Store,2016-10-08,297343.69,-641.73,entertainment,Alice Johnson,CURRENT
9ab09351-03aa-406e-aa35-c54591d370e6,bank_a_00.uk,INCOME,2016-10-09,209816.82,33000.00,INCOME,John Smith,CURRENT
2b282de9-e022-4dfe-bed8-8f5085219269,bank_a_00.uk,Pep Boys,2016-10-09,207982.58,-1834.24,auto,John Smith,CURRENT
4be48213-1bed-4ace-af79-815f9270d94d,bank_a_00.uk,Annual Fee,2016-10-16,207561.16,-421.42,fee,John Smith,CURRENT
58b6dd1f-2ac1-4db5-b2a4-1d1ec888bec0,bank_a_00.uk,In-N-Out Burger,2016-10-17,207067.89,-493.27,food,John Smith,CURRENT
48235189-78fe-4477-a5ea-c6f817446a40,bank_a_00.uk,Apple Store,2016-10-22,206800.13,-267.76,gift,John Smith,CURRENT
d6ceaeea-510f-4bb8-b3d8-aa41606989c5,bank_a_00.uk,In-N-Out Burger,2016-10-24,206273.06,-527.07,food,John Smith,CURRENT
322f5a96-2c1b-4af0-8cad-a57d40555200,bank_a_00.uk,Netflix,2016-10-26,205870.30,-402.76,entertainment,John Smith,CURRENT
e6df94ff-6c0a-4331-9b4f-b3dff27c0be0,bank_a_00.uk,Kenneth Cole,2016-10-29,204764.30,-1106.00,clothing,John Smith,CURRENT
a944cfdd-824f-4472-8b21-3a941ff3c3f7,bank_a_00.uk,Registration,2016-10-30,203849.34,-914.96,education,John Smith,CURRENT
9220ae58-a8da-4312-af89-ea9b04c08193,bank_a_00.uk,In-N-Out Burger,2016-10-31,203428.23,-421.11,food,John Smith,CURRENT
59571725-1ec5-4f13-81f3-9e29bef8bf4c,bank_a_00.uk,In-N-Out Burger,2016-11-04,202883.29,-544.94,food,John Smith,CURRENT
9e62f6cc-88bb-433b-8ed9-a30f5b4ae07a,bank_a_00.uk,In-N-Out Burger,2016-11-05,202187.26,-696.03,food,John Smith,CURRENT
bb452cec-04f4-40bc-8f92-15624b0e8d36,bank_a_00.uk,Comcast,2016-11-05,199920.22,-2267.04,utility,John Smith,CURRENT
bbd80740-fed8-4f40-973b-ffad5408cf92,bank_a_00.uk,In-N-Out Burger,2016-11-06,199318.97,-601.25,food,John Smith,CURRENT
5b1b20ad-f1f9-4476-afa7-5783ed37f45b,bank_a_00.uk,Dr. Jackson,2016-11-06,197496.20,-1822.77,health,John Smith,CURRENT
1bb376ff-6a9f-428f-9b73-1f2de6e50e1b,bank_a_02.uk,INCOME,2016-10-09,2180000.00,30000.00,INCOME,John Smith,SAVING
358f311d-48b0-464e-a0e0-838869f5e908,bank_a_00.uk,INCOME,2016-10-09,720000.00,20000.00,INCOME,Alice Johnson,SAVING
b1f1282c-dda3-450e-ab24-35714e30df31,bank_a_00.uk,INCOME,2016-10-09,357343.69,60000.00,INCOME,Alice Johnson,CURRENT
38c41d64-f0f4-469d-9992-594acc74f4bd,bank_a_00.uk,RENT,2016-10-09,337343.69,-20000.00,RENT,Alice Johnson,CURRENT
db1b79c5-cd0a-4268-91a0-3c10037722c9,bank_a_00.uk,,2016-10-15,335133.01,-2210.68,utility,Alice Johnson,CURRENT
9091a3fd-05e8-453f-960c-6403c6567c41,bank_a_00.uk,iTunes Music Store,2016-10-15,334386.40,-746.61,entertainment,Alice Johnson,CURRENT
f6c2df8d-2634-471a-af53-11671bce9824,bank_a_00.uk,Dr. Roberts,2016-10-16,333222.06,-1164.34,health,Alice Johnson,CURRENT
96dbfe5d-b56f-4585-8f49-1f06f7bdfd51,bank_a_00.uk,Pep Boys,2016-10-21,331732.07,-1489.99,auto,Alice Johnson,CURRENT
6783bb24-f7e9-4976-9596-55a6242d0958,bank_a_00.uk,Banana Republic,2016-10-27,330219.11,-1512.96,clothing,Alice Johnson,CURRENT
2cab9b80-13e2-45b0-89ed-05fe268885f6,bank_a_00.uk,Whole Foods,2016-10-30,329623.54,-595.57,food,Alice Johnson,CURRENT
892aa7cd-5875-4972-b374-21c3b0e2cf74,bank_a_00.uk,Whole Foods,2016-10-30,329244.62,-378.92,food,Alice Johnson,CURRENT
607dfb2f-09cc-4134-b9f1-d26fe2290fb1,bank_a_00.uk,Nordstrom,2016-10-31,328735.14,-509.48,gift,Alice Johnson,CURRENT
90402144-ebba-4c8f-8c8c-39c0e03b4f98,bank_a_00.uk,Whole Foods,2016-11-01,328070.11,-665.03,food,Alice Johnson,CURRENT
014a4529-87a2-48d0-8de5-7968222cc892,bank_a_00.uk,Whole Foods,2016-11-03,327682.27,-387.84,food,Alice Johnson,CURRENT
5c33b2bf-f02c-40ab-8c44-e714af6156d5,bank_a_00.uk,Whole Foods,2016-11-03,326977.78,-704.49,food,Alice Johnson,CURRENT
db11ad57-e376-4c2d-9389-cc3a72a5bf9a,bank_a_00.uk,The Crucible,2016-11-04,326046.90,-930.88,education,Alice Johnson,CURRENT
887cd364-3a68-4f33-a74b-970d8e41b7c1,bank_a_00.uk,Whole Foods,2016-11-06,325404.67,-642.23,food,Alice Johnson,CURRENT
30a79657-6dc6-4f72-ab8e-b832caff9ae0,bank_a_00.uk,INCOME,2016-11-08,230496.20,33000.00,INCOME,John Smith,CURRENT
400e556c-b6a4-4856-8a28-ec10c2022c17,bank_a_00.uk,Kenneth Cole,2016-11-08,229562.00,-934.20,clothing,John Smith,CURRENT
091ef841-0e07-4665-8547-6e4f3f957c8b,bank_a_00.uk,Monthly Fee,2016-11-08,229198.01,-363.99,fee,John Smith,CURRENT
de87366d-3c33-4640-9d57-9f6bfbefaaf1,bank_a_00.uk,AMC Theaters,2016-11-17,228737.35,-460.66,entertainment,John Smith,CURRENT
70ae8fce-729b-48e1-87cf-619f300f5bbd,bank_a_00.uk,In-N-Out Burger,2016-11-19,228326.49,-410.86,food,John Smith,CURRENT
dcf25aba-afd9-4c04-9ae0-8f02e186a625,bank_a_00.uk,In-N-Out Burger,2016-11-21,227671.31,-655.18,food,John Smith,CURRENT
f05cea1c-3f70-4521-803d-d58e98f5da66,bank_a_00.uk,Wal-Mart,2016-11-26,226135.68,-1535.63,health,John Smith,CURRENT
9dd85240-a03e-4519-8ce7-d1ce278aac89,bank_a_00.uk,In-N-Out Burger,2016-11-28,225749.50,-386.18,food,John Smith,CURRENT
f52f66a8-b7dd-4fbf-a27c-0b8d0eb777fe,bank_a_00.uk,In-N-Out Burger,2016-11-28,225179.88,-569.62,food,John Smith,CURRENT
783a745b-35b7-422d-be40-687ee5fdfb4b,bank_a_00.uk,In-N-Out Burger,2016-12-01,224557.23,-622.65,food,John Smith,CURRENT
a9fcf1b1-6389-4a00-a8a8-53f2e53a898d,bank_a_00.uk,Apple Store,2016-12-02,224034.99,-522.24,gift,John Smith,CURRENT
5e0471fe-6e8f-4de5-8bfa-30296f3259af,bank_a_00.uk,Arco,2016-12-06,222403.54,-1631.45,auto,John Smith,CURRENT
d8bab740-861e-4e52-8b9a-bd38b331c371,bank_a_02.uk,INCOME,2016-11-08,2210000.00,30000.00,INCOME,John Smith,SAVING
b1ddb14d-07e4-4539-ac66-54428aeb14de,bank_a_00.uk,INCOME,2016-11-08,740000.00,20000.00,INCOME,Alice Johnson,SAVING
d3a48cb5-947b-49a1-9c47-3cc7ce550a36,bank_a_00.uk,INCOME,2016-11-08,385404.67,60000.00,INCOME,Alice Johnson,CURRENT
2763ca53-5bd4-4024-aa06-60696c7ac67f,bank_a_00.uk,RENT,2016-11-08,365404.67,-20000.00,RENT,Alice Johnson,CURRENT
f6935d5b-0a0f-4505-8390-59b5ba2624d3,bank_a_00.uk,Trader Joe's,2016-11-09,364904.29,-500.38,food,Alice Johnson,CURRENT
b7d7fb08-42e8-4793-a3d5-15f9a52cc229,bank_a_00.uk,Trader Joe's,2016-11-15,364337.68,-566.61,food,Alice Johnson,CURRENT
d9223cbe-5128-4994-97f1-c7109ec03d24,bank_a_00.uk,Campus Books,2016-11-16,362696.90,-1640.78,education,Alice Johnson,CURRENT
542bb387-97d4-4298-86fd-72f0c23e0eb2,bank_a_00.uk,Trader Joe's,2016-11-17,362236.71,-460.19,food,Alice Johnson,CURRENT
f10e6995-0332-41a0-b96b-29310147f6ad,bank_a_00.uk,Brinks,2016-11-18,360437.29,-1799.42,utility,Alice Johnson,CURRENT
e5ee29f9-99ca-4942-83ab-e736e4a05df1,bank_a_00.uk,Nordstrom,2016-11-18,360117.71,-319.58,gift,Alice Johnson,CURRENT
6884d5a0-d0e4-4b5d-b854-aef3c7ac5bab,bank_a_00.uk,Banana Republic,2016-11-19,359398.19,-719.52,clothing,Alice Johnson,CURRENT
4454c0a2-84cc-4142-9484-445a58635d78,bank_a_00.uk,Amazon.com,2016-11-20,358572.69,-825.50,entertainment,Alice Johnson,CURRENT
8f220e7d-cddd-40c5-9f80-98e3cd6665af,bank_a_00.uk,Annual Fee,2016-11-23,358259.07,-313.62,fee,Alice Johnson,CURRENT
b4b73481-1c83-426a-8939-e9a4c3ba5a52,bank_a_00.uk,Walgreen's,2016-11-24,357228.62,-1030.45,health,Alice Johnson,CURRENT
731d9f25-020e-4e20-87c4-ddea58f91df7,bank_a_00.uk,Trader Joe's,2016-11-27,356876.60,-352.02,food,Alice Johnson,CURRENT
035c507c-bfa9-47f4-9a72-e1e813ffe340,bank_a_00.uk,INCOME,2016-12-08,255403.54,33000.00,INCOME,John Smith,CURRENT
c8a5e2e2-669b-4e08-8f12-ee3ab55d4ff6,bank_a_00.uk,Whole Foods,2016-12-08,254977.16,-426.38,food,John Smith,CURRENT
b9b7f24a-fcbf-47f3-b606-ec476b354cb8,bank_a_00.uk,Whole Foods,2016-12-10,254561.33,-415.83,food,John Smith,CURRENT
9245a47b-cd05-44ef-8ce9-942f234cc60a,bank_a_00.uk,Amazon.com,2016-12-11,253817.01,-744.32,entertainment,John Smith,CURRENT
a3d82da9-36de-43eb-8603-91874f8c3754,bank_a_00.uk,Monthly Fee,2016-12-11,253411.69,-405.32,fee,John Smith,CURRENT
7c543080-150e-4612-b15e-94cf45c8f460,bank_a_00.uk,Union 76,2016-12-13,252094.11,-1317.58,auto,John Smith,CURRENT
fe21d412-1caf-4519-80ae-dfb6c3c54e73,bank_a_00.uk,Dr. Roberts,2016-12-15,250311.90,-1782.21,health,John Smith,CURRENT
301b5c25-0ee8-4c8c-8732-c367e7a326dc,bank_a_00.uk,Kenneth Cole,2016-12-18,248815.28,-1496.62,clothing,John Smith,CURRENT
e2b08e07-f011-42cc-8581-16f7949aeaa8,bank_a_00.uk,Neiman-Marcus,2016-12-31,248495.33,-319.95,gift,John Smith,CURRENT
3d219f84-38d2-4e64-8ca1-50531e230cb8,bank_a_00.uk,Registration,2016-12-31,247241.04,-1254.29,education,John Smith,CURRENT
c28e8e40-dd8f-43d5-b6f3-8b73eda83239,bank_a_00.uk,Whole Foods,2017-01-05,246760.74,-480.30,food,John Smith,CURRENT
fa54096c-2e9f-40f4-9b67-0c4b2386de86,bank_a_00.uk,Whole Foods,2017-01-07,246324.45,-436.29,food,John Smith,CURRENT
4e235d64-96cf-4eb5-a1fc-55d1e84cf424,bank_a_00.uk,Whole Foods,2017-01-07,245944.41,-380.04,food,John Smith,CURRENT
3f41ddc8-811c-4958-926a-1bb665f8bf74,bank_a_02.uk,INCOME,2016-12-08,2240000.00,30000.00,INCOME,John Smith,SAVING
0a3873bb-f413-4023-be1e-dc3cb0e6573b,bank_a_00.uk,INCOME,2016-12-08,760000.00,20000.00,INCOME,Alice Johnson,SAVING
9fbb4885-c24b-4d55-b5a5-fd4be0c8d3ee,bank_a_00.uk,INCOME,2016-12-08,416876.60,60000.00,INCOME,Alice Johnson,CURRENT
5d36bc38-6006-4385-90c3-6465a60f3a6d,bank_a_00.uk,Starbucks,2016-12-08,416338.94,-537.66,food,Alice Johnson,CURRENT
29a0f4a7-df07-49c2-81c1-70771c7f5170,bank_a_00.uk,PG&E,2016-12-08,414306.92,-2032.02,utility,Alice Johnson,CURRENT
7f4b3335-a0b9-4580-ac20-e9eed1ba9091,bank_a_00.uk,Amazon.com,2016-12-08,413651.12,-655.80,entertainment,Alice Johnson,CURRENT
babc2693-fb27-493b-90d2-f0a9d1f97f97,bank_a_00.uk,RENT,2016-12-08,393651.12,-20000.00,RENT,Alice Johnson,CURRENT
c7b02679-5880-4a70-bb79-8b61e48c2f4a,bank_a_00.uk,Kenneth Cole,2016-12-20,392214.12,-1437.00,clothing,Alice Johnson,CURRENT
6f11d0b0-25ef-4a2e-9f1e-9f512fdd024b,bank_a_00.uk,Starbucks,2016-12-21,391670.86,-543.26,food,Alice Johnson,CURRENT
4faac38f-602e-45ef-9975-dc9327b977bf,bank_a_00.uk,Campus Books,2016-12-21,390446.81,-1224.05,education,Alice Johnson,CURRENT
58133b39-f1a4-465f-968b-c5890f945f47,bank_a_00.uk,Apple Store,2016-12-22,390059.01,-387.80,gift,Alice Johnson,CURRENT
cbe10245-284e-4f49-86a3-b9b493b7a1ba,bank_a_00.uk,Starbucks,2017-01-03,389653.21,-405.80,food,Alice Johnson,CURRENT
4e0d0c3e-b918-423a-bb56-a8053bd3b23a,bank_a_00.uk,Dr. Jackson,2017-01-03,388510.14,-1143.07,health,Alice Johnson,CURRENT
bc55e780-0a9d-48dd-8b20-19cf5bddec8f,bank_a_00.uk,Starbucks,2017-01-05,388199.09,-311.05,food,Alice Johnson,CURRENT
f5358182-aeb5-45ca-857c-767945fedd67,bank_a_00.uk,INCOME,2017-01-07,278944.41,33000.00,INCOME,John Smith,CURRENT
3ee35c08-dd72-43b4-9f34-ee9c671e5cc3,bank_a_00.uk,Starbucks,2017-01-07,278580.12,-364.29,food,John Smith,CURRENT
82b16802-8e47-442e-bdd0-9f2507ea1f4c,bank_a_00.uk,Metreon Theaters,2017-01-07,277921.22,-658.90,entertainment,John Smith,CURRENT
6b1a5241-d6a2-44ac-8ae3-c3c7443f5ead,bank_a_00.uk,Amazon.com,2017-01-07,276213.59,-1707.63,education,John Smith,CURRENT
807ff1ab-4177-4d27-a633-ac00b482e63c,bank_a_00.uk,Overlimit Fee,2017-01-10,275846.75,-366.84,fee,John Smith,CURRENT
9328edaf-9a34-430e-9379-d98718635312,bank_a_00.uk,Starbucks,2017-01-11,275230.78,-615.97,food,John Smith,CURRENT
a4669b05-0cb4-4219-a210-1994674f0735,bank_a_00.uk,Walgreen's,2017-01-13,273552.93,-1677.85,health,John Smith,CURRENT
7ea4487b-40b8-4e44-be50-216127dd3797,bank_a_00.uk,Starbucks,2017-01-20,273100.52,-452.41,food,John Smith,CURRENT
de72fe86-6c85-445f-bf5a-3c1f7554a6f6,bank_a_00.uk,Starbucks,2017-01-21,272687.21,-413.31,food,John Smith,CURRENT
cc425cdc-8895-4761-9db5-7041e9cbcdc4,bank_a_00.uk,Verizon,2017-01-21,270934.70,-1752.51,utility,John Smith,CURRENT
ff9582b7-03d0-451c-92e7-8eb464311ff8,bank_a_00.uk,Pep Boys,2017-01-21,269799.98,-1134.72,auto,John Smith,CURRENT
8e991729-d77f-44ba-8a57-af3186b45d2c,bank_a_00.uk,Starbucks,2017-02-02,269327.00,-472.98,food,John Smith,CURRENT
1069ede2-24d5-4d7c-bb5e-0d8d66b31a2b,bank_a_00.uk,Starbucks,2017-02-02,268942.74,-384.26,food,John Smith,CURRENT
9c78c33e-29cc-4679-8c0e-84add2e06d36,bank_a_00.uk,Nordstrom,2017-02-03,267897.18,-1045.56,clothing,John Smith,CURRENT
1f53f9fc-3a5b-4e55-9735-c81bbadf2c89,bank_a_02.uk,INCOME,2017-01-07,2270000.00,30000.00,INCOME,John Smith,SAVING
ae8ac7a3-69ca-454a-a631-a166eae54aeb,bank_a_00.uk,INCOME,2017-01-07,780000.00,20000.00,INCOME,Alice Johnson,SAVING
bb100cf8-006e-4f6c-a13f-be5dd2fa7946,bank_a_00.uk,INCOME,2017-01-07,448199.09,60000.00,INCOME,Alice Johnson,CURRENT
85d381de-4f8f-428c-ab30-365c6d896326,bank_a_00.uk,RENT,2017-01-07,428199.09,-20000.00,RENT,Alice Johnson,CURRENT
ad448203-a9d4-4d04-9a37-b67ee578a836,bank_a_00.uk,The Crucible,2017-01-26,427409.30,-789.79,education,Alice Johnson,CURRENT
a4c1e3c8-c176-4dc2-aed8-d5c94ffee4fe,bank_a_00.uk,Brinks,2017-01-27,426272.66,-1136.64,utility,Alice Johnson,CURRENT
62e72fa1-a219-4016-b79d-18c4b88bcb10,bank_a_00.uk,Safeway,2017-01-30,425923.33,-349.33,food,Alice Johnson,CURRENT
d158304c-bdda-4f6c-86f0-34abb12f1c5e,bank_a_00.uk,Safeway,2017-01-31,425370.92,-552.41,food,Alice Johnson,CURRENT
1abefb90-2719-45f2-8e93-63749aae41b1,bank_a_00.uk,J. Crew,2017-02-01,424583.65,-787.27,clothing,Alice Johnson,CURRENT
2908d428-2c92-419e-bb4b-8a7bfd547ec0,bank_a_00.uk,Monthly Fee,2017-02-01,424159.91,-423.74,fee,Alice Johnson,CURRENT
2823be39-d12a-40d7-b68a-908f0940c1cf,bank_a_00.uk,Safeway,2017-02-03,423612.16,-547.75,food,Alice Johnson,CURRENT
b0e13a03-2ea7-4915-8c10-f5fbc1203898,bank_a_00.uk,Safeway,2017-02-03,423201.76,-410.40,food,Alice Johnson,CURRENT
73192d0c-8560-4996-ab6a-c82c715bddd5,bank_a_00.uk,Chevron,2017-02-03,422221.08,-980.68,auto,Alice Johnson,CURRENT
aa22c2ed-8f79-4caa-a5f1-7d73302316a1,bank_a_00.uk,Safeway,2017-02-05,421839.08,-382.00,food,Alice Johnson,CURRENT
b7a0d9e3-c34a-4088-b1f7-df3bfde8eb16,bank_a_00.uk,Walgreen's,2017-02-05,420886.10,-952.98,health,Alice Johnson,CURRENT
9ca80888-db80-4f12-b7d0-f121aea29a29,bank_a_00.uk,AMC Theaters,2017-02-05,420243.93,-642.17,entertainment,Alice Johnson,CURRENT
11256f4d-f842-4bff-8fc3-b27ea4c23232,bank_a_00.uk,INCOME,2017-02-06,300897.18,33000.00,INCOME,John Smith,CURRENT
b4e2f5da-569d-4a2b-94f0-7207d17c0b80,bank_a_00.uk,Banana Republic,2017-02-06,299281.04,-1616.14,clothing,John Smith,CURRENT
31abc912-8939-4eb7-b422-986bdd56b251,bank_a_00.uk,Shell,2017-02-07,298089.22,-1191.82,auto,John Smith,CURRENT
38c737e7-2ef3-4c2e-b81c-5cfc0e231611,bank_a_00.uk,Safeway,2017-02-15,297586.25,-502.97,food,John Smith,CURRENT
5ff856e1-09ea-42b6-840e-4a4591352f5a,bank_a_00.uk,Dr. Roberts,2017-02-15,296387.37,-1198.88,health,John Smith,CURRENT
229ce532-6f98-4405-9b74-344e7ad9e664,bank_a_00.uk,Netflix,2017-02-17,295764.39,-622.98,entertainment,John Smith,CURRENT
0c710a6e-af51-48e7-be1d-b9459fe23124,bank_a_00.uk,Tuition,2017-02-18,294105.88,-1658.51,education,John Smith,CURRENT
4cfcdcf7-2c71-4623-bd8b-e871e2d45b01,bank_a_00.uk,Safeway,2017-02-27,293491.18,-614.70,food,John Smith,CURRENT
22efbb07-1139-467a-ae1d-a7d90a374e67,bank_a_00.uk,Safeway,2017-02-28,293125.70,-365.48,food,John Smith,CURRENT
bef08d2d-cb52-4362-9f55-8e875dd8ef28,bank_a_00.uk,Safeway,2017-03-04,292809.68,-316.02,food,John Smith,CURRENT
16c7fb54-4f3f-4fd8-a315-4f3b9f9893f9,bank_a_00.uk,Verizon,2017-03-08,291519.02,-1290.66,utility,John Smith,CURRENT
a73183dc-aacf-4661-9bae-b738541aef09,bank_a_02.uk,INCOME,2017-02-06,2300000.00,30000.00,INCOME,John Smith,SAVING
57d4020c-5526-489e-b7d7-6db6135ff18d,bank_a_00.uk,INCOME,2017-02-06,800000.00,20000.00,INCOME,Alice Johnson,SAVING
9846cb3a-b870-4007-aa5d-3eaba0ba6389,bank_a_00.uk,INCOME,2017-02-06,480243.93,60000.00,INCOME,Alice Johnson,CURRENT
8a44e4a1-a29c-474d-a3b1-8a0c01bcb909,bank_a_00.uk,K&L Wines,2017-02-06,479941.75,-302.18,gift,Alice Johnson,CURRENT
80ab96cb-d473-4008-b0b0-c55469cef2a3,bank_a_00.uk,RENT,2017-02-06,459941.75,-20000.00,RENT,Alice Johnson,CURRENT
88b321a1-2e4d-432f-9e30-46631f0b8405,bank_a_00.uk,Trader Joe's,2017-02-07,459479.80,-461.95,food,Alice Johnson,CURRENT
2dd6c551-e568-4bca-b956-22aaff12e2dd,bank_a_00.uk,AMC Theaters,2017-02-07,458991.85,-487.95,entertainment,Alice Johnson,CURRENT
30f04bff-4647-4900-858f-11dfc09e28f8,bank_a_00.uk,Nordstrom,2017-02-18,458086.94,-904.91,clothing,Alice Johnson,CURRENT
2203c494-d10b-4026-b33b-44fde59ef1e3,bank_a_00.uk,Chevron,2017-02-18,457214.58,-872.36,auto,Alice Johnson,CURRENT
fa946519-2383-44d0-916d-6b13f0f1f910,bank_a_00.uk,Trader Joe's,2017-02-25,456777.09,-437.49,food,Alice Johnson,CURRENT
f78db2f7-a323-44a6-9bfd-160d53c21630,bank_a_00.uk,Trader Joe's,2017-02-25,456164.82,-612.27,food,Alice Johnson,CURRENT
7c99094e-b444-478f-9717-2cbc81a27a40,bank_a_00.uk,Trader Joe's,2017-02-26,455677.57,-487.25,food,Alice Johnson,CURRENT
72041698-0be6-4d99-8674-199b6c8cd638,bank_a_00.uk,Dr. Phillips,2017-02-27,453945.32,-1732.25,health,Alice Johnson,CURRENT
910f06e9-b249-4adc-8099-ba441be72406,bank_a_00.uk,Trader Joe's,2017-03-04,453385.81,-559.51,food,Alice Johnson,CURRENT
750884c6-4cec-4511-abe7-15afcd919026,bank_a_00.uk,Trader Joe's,2017-03-08,452962.05,-423.76,food,Alice Johnson,CURRENT
973a68dd-4c72-41c1-a44a-0522c8b2eb23,bank_a_00.uk,INCOME,2017-03-08,324519.02,33000.00,INCOME,John Smith,CURRENT
edb015e9-ba40-4a86-b664-2d5d17aef701,bank_a_00.uk,Olive Garden,2017-03-11,323839.99,-679.03,food,John Smith,CURRENT
21ee4348-5a5f-49c0-93d3-41c37004b17c,bank_a_00.uk,Apple Store,2017-03-14,323578.20,-261.79,gift,John Smith,CURRENT
ba89d57f-ea45-4f46-9391-3d58452caf9c,bank_a_00.uk,Olive Garden,2017-03-17,323258.92,-319.28,food,John Smith,CURRENT
d9f507c2-b36b-42d3-a34a-8862c3ca4f1e,bank_a_00.uk,Olive Garden,2017-03-18,322773.95,-484.97,food,John Smith,CURRENT
78637f49-b0f7-44c1-9469-8b1e6f466caf,bank_a_00.uk,Olive Garden,2017-03-19,322420.21,-353.74,food,John Smith,CURRENT
5f9eb007-fa90-4237-8823-1f749fdfe287,bank_a_00.uk,Jiffy Lube,2017-03-19,320549.15,-1871.06,auto,John Smith,CURRENT
3d6724de-e8a3-4728-84c8-ae840a8eb65e,bank_a_00.uk,Banana Republic,2017-03-23,319158.57,-1390.58,clothing,John Smith,CURRENT
ee4b6aea-2f22-4353-bbe0-4004e91a1fb2,bank_a_00.uk,The Crucible,2017-03-24,318041.71,-1116.86,education,John Smith,CURRENT
d454d5f5-1926-4517-89d7-9b7258abfe0a,bank_a_00.uk,Olive Garden,2017-03-25,317404.49,-637.22,food,John Smith,CURRENT
5bdb6132-5c3f-4e9c-98cb-c0f2b4be55bf,bank_a_00.uk,Verizon,2017-04-01,315233.50,-2170.99,utility,John Smith,CURRENT
1227c0a4-5160-4469-a172-78428a395e47,bank_a_00.uk,Netflix,2017-04-03,314728.02,-505.48,entertainment,John Smith,CURRENT
0dd48a27-f9e2-42e9-85e0-56a9a699f4d8,bank_a_00.uk,Olive Garden,2017-04-07,314260.54,-467.48,food,John Smith,CURRENT
f27cf994-d18e-4f5a-85cd-6a2f9228e9cc,bank_a_02.uk,INCOME,2017-03-08,2330000.00,30000.00,INCOME,John Smith,SAVING
339cdaa7-31e2-4225-a916-fd27e9006769,bank_a_00.uk,INCOME,2017-03-08,820000.00,20000.00,INCOME,Alice Johnson,SAVING
87375494-c1d3-4a2a-91c6-0196f475624b,bank_a_00.uk,INCOME,2017-03-08,512962.05,60000.00,INCOME,Alice Johnson,CURRENT
75539fa2-4978-4822-b96f-4f5c160d9b03,bank_a_00.uk,RENT,2017-03-08,492962.05,-20000.00,RENT,Alice Johnson,CURRENT
191e0110-027d-4bfb-8d16-b7d526f4fb3f,bank_a_00.uk,Whole Foods,2017-03-09,492289.18,-672.87,food,Alice Johnson,CURRENT
75d45737-dab5-456f-9563-0c1c3c2542ad,bank_a_00.uk,Brinks,2017-03-10,490649.06,-1640.12,utility,Alice Johnson,CURRENT
45a183e7-3c63-4d66-9945-24ead0ad9d65,bank_a_00.uk,Arco,2017-03-10,489544.54,-1104.52,auto,Alice Johnson,CURRENT
df62ecb6-a83e-469e-a53c-8d4de9c8e54e,bank_a_00.uk,Dr. Martins,2017-03-11,487924.50,-1620.04,health,Alice Johnson,CURRENT
42197c82-bc39-4954-862e-1f60ab259a55,bank_a_00.uk,The Gap,2017-03-16,487103.15,-821.35,clothing,Alice Johnson,CURRENT
c44f4c53-8280-4608-840c-1f547ca1c4da,bank_a_00.uk,Whole Foods,2017-03-18,486624.00,-479.15,food,Alice Johnson,CURRENT
14011ac8-748d-4532-a7c9-beba3a45ffa9,bank_a_00.uk,Whole Foods,2017-03-23,486260.07,-363.93,food,Alice Johnson,CURRENT
cec3dfac-86aa-4e9a-bc32-10212d8386ef,bank_a_00.uk,Whole Foods,2017-03-30,485680.83,-579.24,food,Alice Johnson,CURRENT
020dc1c9-60da-4c24-b079-86038c214e29,bank_a_00.uk,Whole Foods,2017-03-30,485282.75,-398.08,food,Alice Johnson,CURRENT
f24f3f84-cb50-4de5-a13b-79af438bc09a,bank_a_00.uk,Campus Books,2017-03-30,484312.16,-970.59,education,Alice Johnson,CURRENT
9dc84452-27f5-468b-b79e-2c636b705af7,bank_a_00.uk,Overlimit Fee,2017-03-30,483867.93,-444.23,fee,Alice Johnson,CURRENT
d2f64d09-80b9-48d9-b246-cb2772123cc6,bank_a_00.uk,Nordstrom,2017-04-01,483570.76,-297.17,gift,Alice Johnson,CURRENT
cb79e3c5-de86-4676-8dec-4741eb128114,bank_a_00.uk,Whole Foods,2017-04-05,482913.11,-657.65,food,Alice Johnson,CURRENT
a6391daf-7d95-4e23-b524-177c63bd1702,bank_a_00.uk,iTunes Music Store,2017-04-06,482402.13,-510.98,entertainment,Alice Johnson,CURRENT
b54c2185-535d-43e2-8417-c6c3f0ad718a,bank_a_00.uk,INCOME,2017-04-07,347260.54,33000.00,INCOME,John Smith,CURRENT
219f1f2a-9e10-4bbe-a335-dfa04011e0fd,bank_a_00.uk,Dr. Martins,2017-04-13,345429.38,-1831.16,health,John Smith,CURRENT
57c3905e-73ae-4b86-b781-5b5f510072b7,bank_a_00.uk,Union 76,2017-04-18,343475.80,-1953.58,auto,John Smith,CURRENT
b004344d-1ba8-40c7-8fa5-61ac0fa6524c,bank_a_00.uk,Trader Joe's,2017-04-19,342842.53,-633.27,food,John Smith,CURRENT
89a60814-49c9-4adf-954b-b1fb424136e2,bank_a_00.uk,Amazon.com,2017-04-23,341929.96,-912.57,education,John Smith,CURRENT
146675e1-4cfb-4d84-ae8e-ccf5d08596ba,bank_a_00.uk,Macy's,2017-04-25,340760.06,-1169.90,clothing,John Smith,CURRENT
7e0b6424-4ee6-422c-9466-2cf81a8bb251,bank_a_00.uk,Trader Joe's,2017-04-26,340404.52,-355.54,food,John Smith,CURRENT
3ef70866-09ea-4af3-b70e-a93cf0a6d015,bank_a_00.uk,Trader Joe's,2017-05-01,339896.74,-507.78,food,John Smith,CURRENT
229edf0a-e769-4d76-a3f7-c878d9af5e22,bank_a_00.uk,Trader Joe's,2017-05-04,339308.68,-588.06,food,John Smith,CURRENT
3f7a3bf8-46a4-43be-bbd1-b06f3136dd1f,bank_a_00.uk,Trader Joe's,2017-05-06,338752.38,-556.30,food,John Smith,CURRENT
f258c989-9465-45a5-a53b-8c7e53f6220e,bank_a_00.uk,Trader Joe's,2017-05-07,338367.54,-384.84,food,John Smith,CURRENT
eb961558-0a48-4917-8501-20efac89d884,bank_a_00.uk,Rhapsody,2017-05-07,337844.24,-523.30,entertainment,John Smith,CURRENT
a1b8313c-d3a6-49ff-844d-00b414cfffee,bank_a_00.uk,Neiman-Marcus,2017-05-07,337390.50,-453.74,gift,John Smith,CURRENT
f4fc2bba-a1bb-4562-9eaa-97f9b95eed3f,bank_a_02.uk,INCOME,2017-04-07,2360000.00,30000.00,INCOME,John Smith,SAVING
411c3d58-3515-4aed-abf8-3d9778776ab0,bank_a_00.uk,INCOME,2017-04-07,840000.00,20000.00,INCOME,Alice Johnson,SAVING
45b81aae-6ac1-415a-a7d5-87b3162a488f,bank_a_00.uk,INCOME,2017-04-07,542402.13,60000.00,INCOME,Alice Johnson,CURRENT
7ec4b71e-e220-44bd-9be8-a14310af58da,bank_a_00.uk,RENT,2017-04-07,522402.13,-20000.00,RENT,Alice Johnson,CURRENT
dfdcfef5-a0da-4f81-8429-131f025c0079,bank_a_00.uk,AMC Theaters,2017-04-12,521611.95,-790.18,entertainment,Alice Johnson,CURRENT
b73fd3af-6445-4312-a52c-96530a4ccba2,bank_a_00.uk,In-N-Out Burger,2017-04-14,521221.72,-390.23,food,Alice Johnson,CURRENT
4bfacdf0-7875-4186-9c79-c2b6564e1a33,bank_a_00.uk,Dr. Phillips,2017-04-17,520099.33,-1122.39,health,Alice Johnson,CURRENT
e4da1a4c-4f4a-4e7e-91c5-e271625109ea,bank_a_00.uk,In-N-Out Burger,2017-04-21,519457.51,-641.82,food,Alice Johnson,CURRENT
985d7e02-67e1-4ddc-b8e9-874ed2d6c16c,bank_a_00.uk,Kenneth Cole,2017-04-24,518487.64,-969.87,clothing,Alice Johnson,CURRENT
cd93485d-3be5-46be-9691-baa041000e02,bank_a_00.uk,In-N-Out Burger,2017-04-25,517874.47,-613.17,food,Alice Johnson,CURRENT
c32d14b7-61b9-4f92-b4bd-6b57b4405d05,bank_a_00.uk,Amazon.com,2017-04-25,517394.62,-479.85,gift,Alice Johnson,CURRENT
6fe559fd-ecca-4658-808a-165dfdb863fd,bank_a_00.uk,The Crucible,2017-04-25,515977.00,-1417.62,education,Alice Johnson,CURRENT
f00f349b-65c5-473a-a003-b0f2c97b60ed,bank_a_00.uk,In-N-Out Burger,2017-04-26,515540.80,-436.20,food,Alice Johnson,CURRENT
003ca990-d7ba-4758-aba7-60ed7476fe5b,bank_a_00.uk,Comcast,2017-04-28,513909.57,-1631.23,utility,Alice Johnson,CURRENT
8de36d49-f964-4c2f-ad69-5970d995ef88,bank_a_00.uk,In-N-Out Burger,2017-05-01,513196.24,-713.33,food,Alice Johnson,CURRENT
9019dfad-0012-4be9-bba1-a8b1c954c520,bank_a_00.uk,Interest Fee,2017-05-01,512875.19,-321.05,fee,Alice Johnson,CURRENT
a246fa33-e7f1-4038-a3db-54cc813fcfe6,bank_a_00.uk,In-N-Out Burger,2017-05-06,512304.27,-570.92,food,Alice Johnson,CURRENT
44a8d068-811c-46aa-a461-77d690bfe1ff,bank_a_00.uk,INCOME,2017-05-07,370390.50,33000.00,INCOME,John Smith,CURRENT
c754872b-c0b2-461c-8fba-c200107e6702,bank_a_00.uk,Walgreen's,2017-05-07,368750.45,-1640.05,health,John Smith,CURRENT
155e012c-5731-4e88-8902-bf47a7f4f2d4,bank_a_00.uk,Trader Joe's,2017-05-08,368234.26,-516.19,food,John Smith,CURRENT
f569798a-4dd6-475d-84b2-fa5af2e63c9d,bank_a_00.uk,Netflix,2017-05-12,367562.90,-671.36,entertainment,John Smith,CURRENT
75a12675-4e7d-4ba6-bd9a-bbd7b350834c,bank_a_00.uk,Nordstrom,2017-05-18,367246.93,-315.97,gift,John Smith,CURRENT
6a8886a3-db83-4b09-b92e-934bec6aab44,bank_a_00.uk,Campus Books,2017-05-18,365984.48,-1262.45,education,John Smith,CURRENT
1b5d3ea3-f75b-42f3-951f-bb6b2a0eb32c,bank_a_00.uk,Trader Joe's,2017-05-23,365491.14,-493.34,food,John Smith,CURRENT
172793b0-bf35-4531-97bb-89a22e42217c,bank_a_00.uk,Trader Joe's,2017-05-25,365133.62,-357.52,food,John Smith,CURRENT
c3603a2d-9f31-4300-ba40-4da1bd553770,bank_a_00.uk,Trader Joe's,2017-05-25,364703.50,-430.12,food,John Smith,CURRENT
045972dc-40df-4429-a5e4-1efe955487e6,bank_a_00.uk,Trader Joe's,2017-05-25,364391.28,-312.22,food,John Smith,CURRENT
c35b3d58-f2f5-482e-87e4-96e1941effaf,bank_a_00.uk,,2017-05-26,362183.42,-2207.86,utility,John Smith,CURRENT
13473c01-4302-49cf-a935-fa19c0e10384,bank_a_00.uk,Overlimit Fee,2017-05-31,361775.39,-408.03,fee,John Smith,CURRENT
db79b84a-ea87-45dd-accb-3f51ba91bc89,bank_a_00.uk,Macy's,2017-06-01,360569.69,-1205.70,clothing,John Smith,CURRENT
1523efe2-ac5d-439e-acc5-536e11faed33,bank_a_00.uk,Trader Joe's,2017-06-03,359860.40,-709.29,food,John Smith,CURRENT
feb417a3-9a48-4f57-aab7-8c2d5eeef135,bank_a_00.uk,Jiffy Lube,2017-06-05,357914.93,-1945.47,auto,John Smith,CURRENT
b4324f36-1da5-4023-b35c-b3cd5b920496,bank_a_02.uk,INCOME,2017-05-07,2390000.00,30000.00,INCOME,John Smith,SAVING
42d9b7ff-ae30-42c6-ab04-3a147736ccd1,bank_a_00.uk,INCOME,2017-05-07,860000.00,20000.00,INCOME,Alice Johnson,SAVING
aebbd8a7-6b23-4e91-ab6f-40184bb7ca6f,bank_a_00.uk,INCOME,2017-05-07,572304.27,60000.00,INCOME,Alice Johnson,CURRENT
c2e3ab55-c740-45dd-b99e-fec3b8fa9e4a,bank_a_00.uk,RENT,2017-05-07,552304.27,-20000.00,RENT,Alice Johnson,CURRENT
b7120610-1911-4136-bbb0-a6bf3ca4b4e7,bank_a_00.uk,Olive Garden,2017-05-08,551796.44,-507.83,food,Alice Johnson,CURRENT
533644df-4969-4a50-b6e4-02c32c527c1b,bank_a_00.uk,Macy's,2017-05-09,550779.29,-1017.15,clothing,Alice Johnson,CURRENT
9fea258b-e577-4401-beab-dbb23e661ef6,bank_a_00.uk,Rhapsody,2017-05-09,550405.00,-374.29,entertainment,Alice Johnson,CURRENT
b21d5553-a554-4683-8e28-3be2a6b1a67c,bank_a_00.uk,Olive Garden,2017-05-10,549942.59,-462.41,food,Alice Johnson,CURRENT
ca4bc71f-0a62-4088-b140-5789ee2f438e,bank_a_00.uk,Dr. Martins,2017-05-13,548688.08,-1254.51,health,Alice Johnson,CURRENT
80c16de5-2e05-466d-ab31-a3b740ca31eb,bank_a_00.uk,Registration,2017-05-14,547263.00,-1425.08,education,Alice Johnson,CURRENT
5bea5ef3-9a57-4ca7-8f91-b914407c00a0,bank_a_00.uk,Olive Garden,2017-05-15,546781.83,-481.17,food,Alice Johnson,CURRENT
5e9b55d6-2223-444b-8327-9c5a259c2835,bank_a_00.uk,Verizon,2017-05-26,544986.78,-1795.05,utility,Alice Johnson,CURRENT
78e3eda4-0ee9-40eb-af1c-875153b72d58,bank_a_00.uk,Jiffy Lube,2017-05-26,543878.94,-1107.84,auto,Alice Johnson,CURRENT
a7098a99-f16a-45d5-8e58-5e7b665280a9,bank_a_00.uk,K&L Wines,2017-05-28,543424.11,-454.83,gift,Alice Johnson,CURRENT
0e94add5-bf79-418b-94e3-eb86eec4d63e,bank_a_00.uk,Overlimit Fee,2017-06-01,542963.94,-460.17,fee,Alice Johnson,CURRENT
4b5399b3-7d64-4dda-b950-72f9a8d1aa63,bank_a_00.uk,Olive Garden,2017-06-05,542489.30,-474.64,food,Alice Johnson,CURRENT
3666456b-d09c-4cbd-9bbc-bd98e4aa5183,bank_a_00.uk,INCOME,2017-06-06,390914.93,33000.00,INCOME,John Smith,CURRENT
e6c5fd10-5019-4594-ba1d-e68278e02eeb,bank_a_00.uk,Registration,2017-06-08,389663.03,-1251.90,education,John Smith,CURRENT
8586fae9-a81d-4c2f-895d-28d55bd74435,bank_a_00.uk,Trader Joe's,2017-06-13,389324.19,-338.84,food,John Smith,CURRENT
4537a577-fbb3-4016-84e6-5e2019e16f68,bank_a_00.uk,AMC Theaters,2017-06-14,388897.27,-426.92,entertainment,John Smith,CURRENT
e60efdbe-9dcf-4ba6-ba08-68c0c95b3a2e,bank_a_00.uk,Shell,2017-06-16,387057.63,-1839.64,auto,John Smith,CURRENT
a9bc1d1e-3090-43a6-9d1d-925729c77129,bank_a_00.uk,Trader Joe's,2017-06-17,386415.15,-642.48,food,John Smith,CURRENT
4172deda-f0c2-4a68-a13f-0fdb487fbbbf,bank_a_00.uk,Dr. Roberts,2017-06-18,385032.83,-1382.32,health,John Smith,CURRENT
fddbdd0e-d9dc-447b-b46f-68f0962d31ab,bank_a_00.uk,Trader Joe's,2017-06-21,384369.50,-663.33,food,John Smith,CURRENT
9e73c43a-9807-41fa-b656-6c4bd2247e72,bank_a_00.uk,Amazon.com,2017-06-28,384102.86,-266.64,gift,John Smith,CURRENT
04fbb36f-590a-4c8f-aec5-44dcd3165979,bank_a_00.uk,Brinks,2017-06-30,382699.75,-1403.11,utility,John Smith,CURRENT
8b6e5020-0cf5-474c-80dc-fe936d629dc9,bank_a_00.uk,Trader Joe's,2017-07-03,382063.36,-636.39,food,John Smith,CURRENT
3ab21907-4f0d-47cb-8551-9fe058538a56,bank_a_00.uk,Trader Joe's,2017-07-05,381407.63,-655.73,food,John Smith,CURRENT
82b85531-d935-42d3-8d71-eb66d14b0efc,bank_a_00.uk,Trader Joe's,2017-07-06,380973.34,-434.29,food,John Smith,CURRENT
83016a12-85cc-4cbc-9a0a-6e89b11fb398,bank_a_00.uk,Macy's,2017-07-06,379706.65,-1266.69,clothing,John Smith,CURRENT
138aba60-3d5c-42f9-867e-7d4ea3f333b7,bank_a_02.uk,INCOME,2017-06-06,2420000.00,30000.00,INCOME,John Smith,SAVING
095d9327-5059-4ecf-9864-4b1739d6466f,bank_a_00.uk,INCOME,2017-06-06,880000.00,20000.00,INCOME,Alice Johnson,SAVING
57e6c9bf-9b7d-434f-9f38-bb1f9ea95810,bank_a_00.uk,INCOME,2017-06-06,602489.30,60000.00,INCOME,Alice Johnson,CURRENT
0e6c1888-d1a9-4274-ade5-13e0c28a4434,bank_a_00.uk,RENT,2017-06-06,582489.30,-20000.00,RENT,Alice Johnson,CURRENT
85ff93ff-a8b0-4da0-90b7-f0a56683d36f,bank_a_00.uk,Amazon.com,2017-06-07,582130.62,-358.68,gift,Alice Johnson,CURRENT
0fdb0997-e06a-44f1-9c9a-9a3d4e483ad1,bank_a_00.uk,Macy's,2017-06-08,580506.34,-1624.28,clothing,Alice Johnson,CURRENT
71a3cd5c-743f-4a25-81e3-195141e3f8ef,bank_a_00.uk,AMC Theaters,2017-06-21,580107.43,-398.91,entertainment,Alice Johnson,CURRENT
417feebe-be43-4c03-ba39-85e62f7c93d7,bank_a_00.uk,In-N-Out Burger,2017-06-23,579435.29,-672.14,food,Alice Johnson,CURRENT
a49f933e-bf24-4d87-8e4c-8e77bac41e59,bank_a_00.uk,In-N-Out Burger,2017-06-25,578804.42,-630.87,food,Alice Johnson,CURRENT
864a42e1-3c2d-432a-94af-ab045f95827e,bank_a_00.uk,In-N-Out Burger,2017-06-26,578381.16,-423.26,food,Alice Johnson,CURRENT
8e1bcb67-cc38-4579-b8f1-20ab01ae0d81,bank_a_00.uk,Dr. Phillips,2017-07-02,576767.57,-1613.59,health,Alice Johnson,CURRENT
4217f4a5-3ad0-4a71-97bd-2a26a88965c5,bank_a_00.uk,In-N-Out Burger,2017-07-03,576437.08,-330.49,food,Alice Johnson,CURRENT
6bc2b718-0ca6-402f-b814-f03bc27c0052,bank_a_00.uk,In-N-Out Burger,2017-07-05,575726.66,-710.42,food,Alice Johnson,CURRENT
81634145-e7ed-40f0-84f9-5297c7898500,bank_a_00.uk,Shell,2017-07-05,574176.12,-1550.54,auto,Alice Johnson,CURRENT
34dd7727-0d90-4132-b3f8-54e5037916df,bank_a_00.uk,INCOME,2017-07-06,412706.65,33000.00,INCOME,John Smith,CURRENT
13e8b5aa-0740-4ac2-8b6a-c27f93b18ddc,bank_a_00.uk,iTunes Music Store,2017-07-07,412308.99,-397.66,entertainment,John Smith,CURRENT
89fe6584-58f4-4da0-af06-d3a62008e87d,bank_a_00.uk,J. Crew,2017-07-11,411238.69,-1070.30,clothing,John Smith,CURRENT
113c3305-72f4-433d-9771-c99bcd901bd4,bank_a_00.uk,Late Fee,2017-07-13,410756.25,-482.44,fee,John Smith,CURRENT
4660e1ae-a548-49b3-ac17-2be67bf3834b,bank_a_00.uk,Chevron,2017-07-15,408925.14,-1831.11,auto,John Smith,CURRENT
a6b9d9d7-e19d-4f73-bb28-2662de3bce33,bank_a_00.uk,Whole Foods,2017-07-19,408330.33,-594.81,food,John Smith,CURRENT
72150bb7-0840-4945-9e6a-31271c05d7fd,bank_a_00.uk,Whole Foods,2017-07-21,407709.68,-620.65,food,John Smith,CURRENT
4c8716e8-7b16-41c6-9118-9be48633587e,bank_a_00.uk,Dr. Roberts,2017-07-25,406676.68,-1033.00,health,John Smith,CURRENT
c3cbd13c-7dfc-4862-a7d7-f0f13e3a9241,bank_a_00.uk,Whole Foods,2017-07-26,406368.63,-308.05,food,John Smith,CURRENT
31ccbbb2-7f80-4d46-9ca8-274b97e44643,bank_a_00.uk,Whole Foods,2017-07-27,405878.05,-490.58,food,John Smith,CURRENT
7b4cd326-1bc7-4ac9-9c4e-d71e0c1ed0e3,bank_a_02.uk,INCOME,2017-07-06,2450000.00,30000.00,INCOME,John Smith,SAVING
547e9213-6228-49e2-a032-7bab5ac1c03e,bank_a_00.uk,INCOME,2017-07-06,900000.00,20000.00,INCOME,Alice Johnson,SAVING
e7c82c71-22fb-4d50-a34c-62017c09e436,bank_a_00.uk,INCOME,2017-07-06,634176.12,60000.00,INCOME,Alice Johnson,CURRENT
5d9dc22f-600d-4917-8b13-db0e3f274cd9,bank_a_00.uk,RENT,2017-07-06,614176.12,-20000.00,RENT,Alice Johnson,CURRENT
89f9c6c7-900f-4dc7-ae51-23c027001008,bank_a_00.uk,Starbucks,2017-07-07,613489.52,-686.60,food,Alice Johnson,CURRENT
f9ff77e6-5de3-43f2-8dee-5de2d02c94fa,bank_a_00.uk,Starbucks,2017-07-11,613157.03,-332.49,food,Alice Johnson,CURRENT
580d068f-31ea-46a8-96ae-b629b16a276b,bank_a_00.uk,Nordstrom,2017-07-11,612697.72,-459.31,gift,Alice Johnson,CURRENT
24ec0c22-ba87-4e1c-8896-f56ae911241c,bank_a_00.uk,Chevron,2017-07-14,611503.97,-1193.75,auto,Alice Johnson,CURRENT
062ea858-a726-4d53-a4bc-a1a658cec551,bank_a_00.uk,Starbucks,2017-07-18,611001.81,-502.16,food,Alice Johnson,CURRENT
b9fead54-1429-4c97-8e08-3147fc825e27,bank_a_00.uk,Starbucks,2017-07-22,610564.47,-437.34,food,Alice Johnson,CURRENT
f9b9a4db-091e-4c81-ac18-a4de0ee7b16c,bank_a_00.uk,Starbucks,2017-07-23,610076.09,-488.38,food,Alice Johnson,CURRENT
6328e0bd-ff4b-4638-b1ad-7e4e31268bb9,bank_a_00.uk,iTunes Music Store,2017-07-25,609274.42,-801.67,entertainment,Alice Johnson,CURRENT
6b8878b7-ab8f-4f22-a6d6-7c9116e22b12,bank_a_00.uk,Amazon.com,2017-07-26,607911.72,-1362.70,education,Alice Johnson,CURRENT
7806c4f6-6f54-405f-a5d2-007b40dc0b04,bank_a_00.uk,Banana Republic,2017-07-28,607107.38,-804.34,clothing,Alice Johnson,CURRENT
a9cb720a-5559-4dba-b992-1e6601426d7f,bank_a_00.uk,Verizon,2017-07-30,605836.31,-1271.07,utility,Alice Johnson,CURRENT
bc82f2d9-2abd-4ea4-a653-56229af905e0,bank_a_00.uk,Starbucks,2017-08-03,605523.57,-312.74,food,Alice Johnson,CURRENT
c4207a24-e49b-4e17-a477-7775088bce44,bank_a_00.uk,INCOME,2017-08-05,438878.05,33000.00,INCOME,John Smith,CURRENT
8abc6cfb-9525-44de-8220-5871607b31f9,bank_a_00.uk,Starbucks,2017-08-11,438435.86,-442.19,food,John Smith,CURRENT
8ad6d3e7-8a5c-4563-bf4e-1ac944455561,bank_a_00.uk,Netflix,2017-08-15,437745.65,-690.21,entertainment,John Smith,CURRENT
be6ea5c2-657b-4bb6-acde-ac66691ed77e,bank_a_00.uk,Nordstrom,2017-08-16,437295.04,-450.61,gift,John Smith,CURRENT
f28243fd-6a3e-4091-aee9-4928b766af75,bank_a_00.uk,Registration,2017-08-17,436461.03,-834.01,education,John Smith,CURRENT
8a957cae-92c9-4663-9dcf-2229a2283ea2,bank_a_00.uk,Starbucks,2017-08-18,435836.84,-624.19,food,John Smith,CURRENT
2159fc4d-a206-4dce-a34f-834e07ec455e,bank_a_00.uk,Starbucks,2017-08-19,435354.94,-481.90,food,John Smith,CURRENT
0230614e-fe2b-4f7a-9236-38d76d708752,bank_a_00.uk,Starbucks,2017-08-20,434945.89,-409.05,food,John Smith,CURRENT
a8b054c8-225c-4813-a608-fd542db2d78e,bank_a_00.uk,Brinks,2017-08-25,433425.33,-1520.56,utility,John Smith,CURRENT
0a74521a-0e1f-4b3b-85b4-34c2259b9f07,bank_a_00.uk,Dr. Phillips,2017-08-25,431583.68,-1841.65,health,John Smith,CURRENT
40bbb95a-144f-40ae-ab8b-de05a41ef442,bank_a_00.uk,Kenneth Cole,2017-08-31,430585.42,-998.26,clothing,John Smith,CURRENT
e6f67bb6-059d-41b6-9baf-f855f5b8e5f9,bank_a_02.uk,INCOME,2017-08-05,2480000.00,30000.00,INCOME,John Smith,SAVING
45ed5bbb-3893-47cd-92d6-695aa63fe6ee,bank_a_00.uk,INCOME,2017-08-05,920000.00,20000.00,INCOME,Alice Johnson,SAVING
3082c5d1-a597-4de7-81c1-57cc6f402666,bank_a_00.uk,INCOME,2017-08-05,665523.57,60000.00,INCOME,Alice Johnson,CURRENT
92ac0864-64ee-4e84-82d7-d5951633aff2,bank_a_00.uk,RENT,2017-08-05,645523.57,-20000.00,RENT,Alice Johnson,CURRENT
d824d20b-de2c-4a76-88e7-09ee2d2c1e00,bank_a_00.uk,K&L Wines,2017-08-08,645147.47,-376.10,gift,Alice Johnson,CURRENT
512bbbd0-8f00-45e9-b73a-5ca1c1b009c0,bank_a_00.uk,Trader Joe's,2017-08-11,644481.55,-665.92,food,Alice Johnson,CURRENT
c80ca504-7c0f-4fd1-99d1-68178322c280,bank_a_00.uk,Brinks,2017-08-25,643129.26,-1352.29,utility,Alice Johnson,CURRENT
66f81a9d-1a0b-416d-87fe-32eb1d174efe,bank_a_00.uk,Registration,2017-08-27,642325.97,-803.29,education,Alice Johnson,CURRENT
1b72a2da-64a7-4406-8529-62b94e0dc868,bank_a_00.uk,Trader Joe's,2017-08-28,641880.44,-445.53,food,Alice Johnson,CURRENT
8ec5dabd-8453-43bb-81d8-e4efa257a09f,bank_a_00.uk,AMC Theaters,2017-08-29,641415.31,-465.13,entertainment,Alice Johnson,CURRENT
68047c2a-f78d-44fd-849a-859ae08e693a,bank_a_00.uk,Trader Joe's,2017-08-31,640867.08,-548.23,food,Alice Johnson,CURRENT
26c1cf09-5c34-4672-9b47-20109f2ba966,bank_a_00.uk,The Gap,2017-09-02,639750.91,-1116.17,clothing,Alice Johnson,CURRENT
01434d17-e516-4116-b1ef-6ad81b2a1111,bank_a_00.uk,Trader Joe's,2017-09-03,639044.98,-705.93,food,Alice Johnson,CURRENT
058ff182-c692-40a0-8dfe-473be5dd471d,bank_a_00.uk,Trader Joe's,2017-09-04,638725.99,-318.99,food,Alice Johnson,CURRENT
d4c22aad-749d-4ca2-a870-0297ccd1006b,bank_a_00.uk,INCOME,2017-09-04,463585.42,33000.00,INCOME,John Smith,CURRENT
093c45e6-7afd-413c-9461-894aef90da9a,bank_a_00.uk,Olive Garden,2017-09-04,463207.68,-377.74,food,John Smith,CURRENT
f69b7c38-0a47-42e7-b54e-b36bc7e537b3,bank_a_00.uk,Comcast,2017-09-15,461063.85,-2143.83,utility,John Smith,CURRENT
0562c6f6-a2bd-478d-aa22-655dc74319c3,bank_a_00.uk,Macy's,2017-09-15,460080.94,-982.91,clothing,John Smith,CURRENT
fad27df4-4e48-4fe3-929b-23b0f6559c10,bank_a_00.uk,Tuition,2017-09-17,458587.58,-1493.36,education,John Smith,CURRENT
81f31729-82c9-4ce8-bf17-f208acf027ac,bank_a_00.uk,Pep Boys,2017-09-18,457625.36,-962.22,auto,John Smith,CURRENT
b98f2fb9-86a8-49c6-87dd-8f6f27f7e264,bank_a_00.uk,Amazon.com,2017-09-22,457070.89,-554.47,entertainment,John Smith,CURRENT
c3f5c64f-5b69-4bd8-838d-e9805da96204,bank_a_00.uk,Olive Garden,2017-09-23,456596.35,-474.54,food,John Smith,CURRENT
f647ece0-92fa-4fdf-a616-d8460e3eabc5,bank_a_00.uk,Olive Garden,2017-09-23,456117.59,-478.76,food,John Smith,CURRENT
c8bb0f77-9c04-43c8-b03c-d8c8c03f6a7b,bank_a_00.uk,Olive Garden,2017-09-29,455566.12,-551.47,food,John Smith,CURRENT
30bf6134-cd1d-41d0-bc12-1b9d17614ea9,bank_a_00.uk,Amazon.com,2017-09-29,455074.16,-491.96,gift,John Smith,CURRENT
cf35ca87-31c9-4f99-a3b0-26e65ee86da3,bank_a_02.uk,INCOME,2017-09-04,2510000.00,30000.00,INCOME,John Smith,SAVING
6b4638fa-5fbd-438a-bcb7-af723fe2e5fc,bank_a_00.uk,INCOME,2017-09-04,940000.00,20000.00,INCOME,Alice Johnson,SAVING
f01e4cc8-b46e-42f1-b45b-3d37392d87f9,bank_a_00.uk,INCOME,2017-09-04,698725.99,60000.00,INCOME,Alice Johnson,CURRENT
fb49a495-883f-47bd-9b89-96345e041ded,bank_a_00.uk,RENT,2017-09-04,678725.99,-20000.00,RENT,Alice Johnson,CURRENT
9c4e7883-2de2-4bdc-97ba-71603e656bb5,bank_a_00.uk,Late Fee,2017-09-07,678236.21,-489.78,fee,Alice Johnson,CURRENT
ed30ef6c-86d1-4e48-b4f4-81992664b824,bank_a_00.uk,Trader Joe's,2017-09-08,677725.36,-510.85,food,Alice Johnson,CURRENT
dfd36aed-b1a0-4e0e-ac57-ab2ec6a3dcc8,bank_a_00.uk,Trader Joe's,2017-09-08,677112.51,-612.85,food,Alice Johnson,CURRENT
24254c26-b3f8-4a78-b5cc-c6902c141dc3,bank_a_00.uk,Trader Joe's,2017-09-14,676720.95,-391.56,food,Alice Johnson,CURRENT
73646d19-8411-437d-9a6d-a189886bc786,bank_a_00.uk,Chevron,2017-09-20,675801.86,-919.09,auto,Alice Johnson,CURRENT
10b6b0b9-3f36-459c-8248-6828929ec96e,bank_a_00.uk,Trader Joe's,2017-09-22,675308.62,-493.24,food,Alice Johnson,CURRENT
5317b28e-4b67-4ac3-838f-65f4f48730a6,bank_a_00.uk,Wal-Mart,2017-09-22,673451.06,-1857.56,health,Alice Johnson,CURRENT
43ee1e28-daa2-437e-a7ef-dd94094b0001,bank_a_00.uk,Amazon.com,2017-09-22,672633.73,-817.33,education,Alice Johnson,CURRENT
570da967-f712-44a4-b07a-4479c2d76caf,bank_a_00.uk,Nordstrom,2017-09-24,671153.14,-1480.59,clothing,Alice Johnson,CURRENT
b2e766d6-30e8-47a8-89bc-b70c1bd5cf77,bank_a_00.uk,Amazon.com,2017-09-25,670519.38,-633.76,entertainment,Alice Johnson,CURRENT
8ab3191a-0f35-4424-b316-e240c1207ba8,bank_a_00.uk,PG&E,2017-09-26,668509.68,-2009.70,utility,Alice Johnson,CURRENT
0131ecad-5e41-4794-8d9e-09e0bcb353dd,bank_a_00.uk,Trader Joe's,2017-09-28,667873.54,-636.14,food,Alice Johnson,CURRENT
51af9e47-ed9f-4c18-874c-578bc5517e90,bank_a_00.uk,Apple Store,2017-10-03,667554.50,-319.04,gift,Alice Johnson,CURRENT
03cdb1c6-05d8-4737-90d6-e50d789fe64f,bank_a_00.uk,INCOME,2017-10-04,488074.16,33000.00,INCOME,John Smith,CURRENT
38cad785-c1ca-491e-a1b6-7d4eac1dd0a4,bank_a_00.uk,Comcast,2017-10-04,486298.71,-1775.45,utility,John Smith,CURRENT
273b093d-8b93-4cd4-980f-f65bd2fc35dc,bank_a_00.uk,Safeway,2017-10-09,485759.50,-539.21,food,John Smith,CURRENT
5081a4ff-c491-4f0e-a10c-37d42a42db98,bank_a_00.uk,Safeway,2017-10-10,485050.85,-708.65,food,John Smith,CURRENT
154f00d6-5153-4c12-b217-35414ff10dc4,bank_a_00.uk,Safeway,2017-10-11,484431.73,-619.12,food,John Smith,CURRENT
a676d1a1-4c2f-4ef1-a931-3fad88925d50,bank_a_00.uk,Jiffy Lube,2017-10-11,483265.60,-1166.13,auto,John Smith,CURRENT
533720f3-73c2-478a-8306-468f04d77d89,bank_a_00.uk,Wal-Mart,2017-10-16,482330.06,-935.54,health,John Smith,CURRENT
a1844375-fe32-4a67-b0ac-c6cb1f64b81a,bank_a_00.uk,Safeway,2017-10-20,481692.61,-637.45,food,John Smith,CURRENT
5183b371-5e5a-4dcd-bd8b-e6a317029aa1,bank_a_00.uk,Amazon.com,2017-10-21,480863.32,-829.29,entertainment,John Smith,CURRENT
2d3297f7-0ed0-46ce-b517-f88b0ec8c046,bank_a_00.uk,Nordstrom,2017-10-22,479620.78,-1242.54,clothing,John Smith,CURRENT
e774c102-d888-4483-940d-492330a311c4,bank_a_00.uk,Safeway,2017-10-25,479003.76,-617.02,food,John Smith,CURRENT
58d13fe8-1769-4153-900f-c0ae3445e878,bank_a_00.uk,Tuition,2017-10-29,477510.11,-1493.65,education,John Smith,CURRENT
057f83d2-50d0-4c9c-a05b-025b089d3cbe,bank_a_00.uk,Apple Store,2017-11-03,477159.43,-350.68,gift,John Smith,CURRENT
bd63c1d0-3586-4570-bf5d-3da8cc3dcaaf,bank_a_02.uk,INCOME,2017-10-04,2540000.00,30000.00,INCOME,John Smith,SAVING
23b4f2bd-d473-4fc2-9052-c006f9dc6e70,bank_a_00.uk,INCOME,2017-10-04,960000.00,20000.00,INCOME,Alice Johnson,SAVING
8bb783a4-c9b3-41ba-a891-e16a1b77e516,bank_a_00.uk,INCOME,2017-10-04,727554.50,60000.00,INCOME,Alice Johnson,CURRENT
fdd494bd-755f-47a2-be7f-043bcc6e1513,bank_a_00.uk,RENT,2017-10-04,707554.50,-20000.00,RENT,Alice Johnson,CURRENT
c1e210f3-17a0-4582-bee9-d20915f99824,bank_a_00.uk,Amazon.com,2017-10-10,706445.38,-1109.12,education,Alice Johnson,CURRENT
a92094f3-b20b-494a-9b9f-134b5697c5bf,bank_a_00.uk,Whole Foods,2017-10-11,706065.53,-379.85,food,Alice Johnson,CURRENT
4c59efc2-8ee9-44d0-8f04-a1ef13b11838,bank_a_00.uk,Whole Foods,2017-10-11,705613.13,-452.40,food,Alice Johnson,CURRENT
9040ac44-7f44-4555-8f78-a2bcd4ed1a9a,bank_a_00.uk,Netflix,2017-10-11,704896.92,-716.21,entertainment,Alice Johnson,CURRENT
981f95a9-ccf8-4766-b78a-c18af5bbfa8d,bank_a_00.uk,Amazon.com,2017-10-11,704438.61,-458.31,gift,Alice Johnson,CURRENT
14eb8d30-e592-4657-9414-1dbf750c8b0b,bank_a_00.uk,Whole Foods,2017-10-17,704025.86,-412.75,food,Alice Johnson,CURRENT
59d812cf-2e77-4a28-9a41-1fa776b990a9,bank_a_00.uk,Dr. Jackson,2017-10-17,702816.69,-1209.17,health,Alice Johnson,CURRENT
351c4013-5545-4d62-b028-e42d39701919,bank_a_00.uk,Kenneth Cole,2017-10-18,701264.62,-1552.07,clothing,Alice Johnson,CURRENT
a2330204-b1ff-4eaf-84eb-f249cf28cf3c,bank_a_00.uk,Whole Foods,2017-10-19,700799.52,-465.10,food,Alice Johnson,CURRENT
bca6d413-8552-4a92-bc82-05ba5dd8a5a0,bank_a_00.uk,Whole Foods,2017-10-25,700408.37,-391.15,food,Alice Johnson,CURRENT
8c560ff4-eb11-4950-98a5-78c54679374c,bank_a_00.uk,Whole Foods,2017-10-31,699865.55,-542.82,food,Alice Johnson,CURRENT
d18b9ca1-3fef-4f27-acb4-17ace96ad7d8,bank_a_00.uk,Union 76,2017-11-03,698383.25,-1482.30,auto,Alice Johnson,CURRENT
e47bb3c8-79c6-40f7-828e-eee2e03b8684,bank_a_00.uk,INCOME,2017-11-03,510159.43,33000.00,INCOME,John Smith,CURRENT
8318d3bc-a4b6-4484-bf96-7b6c645e0566,bank_a_00.uk,Apple Store,2017-11-04,509785.77,-373.66,gift,John Smith,CURRENT
c62c7878-b92d-4769-9eda-35b45d4e8f1b,bank_a_00.uk,Nordstrom,2017-11-07,508400.67,-1385.10,clothing,John Smith,CURRENT
234434fe-7d2a-4b67-8d61-300b17394489,bank_a_00.uk,Starbucks,2017-11-09,507946.36,-454.31,food,John Smith,CURRENT
90f033fe-18d0-4e40-94ce-17d286dd60fc,bank_a_00.uk,Starbucks,2017-11-15,507411.25,-535.11,food,John Smith,CURRENT
504237ad-4a21-4af4-b376-11a1fd6afafe,bank_a_00.uk,Starbucks,2017-11-20,506718.97,-692.28,food,John Smith,CURRENT
3c3ba580-98b5-431e-b96f-9ad5ab8853a0,bank_a_00.uk,Jiffy Lube,2017-11-22,505303.15,-1415.82,auto,John Smith,CURRENT
e447ee05-d160-40f1-9ed1-29b24545a381,bank_a_00.uk,AMC Theaters,2017-11-24,504706.75,-596.40,entertainment,John Smith,CURRENT
f4e550c8-2b64-462e-b1f2-1dd778382063,bank_a_00.uk,Starbucks,2017-11-27,504288.68,-418.07,food,John Smith,CURRENT
e680a668-40d6-48dc-9881-6fe375220275,bank_a_00.uk,Brinks,2017-11-27,501847.37,-2441.31,utility,John Smith,CURRENT
720ebfd9-c748-40df-9dba-88b111fc10fd,bank_a_00.uk,Campus Books,2017-11-27,500558.92,-1288.45,education,John Smith,CURRENT
bc28bfd8-a12f-46e2-b10f-47a2b90b3b70,bank_a_00.uk,Dr. Phillips,2017-12-03,499588.11,-970.81,health,John Smith,CURRENT
aa7c9573-ede7-40f2-a8b9-90638d92f884,bank_a_02.uk,INCOME,2017-11-03,2570000.00,30000.00,INCOME,John Smith,SAVING
d36fd664-706a-43f6-8856-606a4189d0dd,bank_a_00.uk,INCOME,2017-11-03,980000.00,20000.00,INCOME,Alice Johnson,SAVING
2a05a06b-0273-4931-aa76-80d34d398134,bank_a_00.uk,INCOME,2017-11-03,758383.25,60000.00,INCOME,Alice Johnson,CURRENT
b1a39c96-c9e9-446e-b5fe-c364e50be489,bank_a_00.uk,RENT,2017-11-03,738383.25,-20000.00,RENT,Alice Johnson,CURRENT
03d6c4b4-042b-469b-b942-e18656ce2c3b,bank_a_00.uk,Olive Garden,2017-11-05,737774.87,-608.38,food,Alice Johnson,CURRENT
086e1ba5-2c5d-45d5-b64c-fb621ecee222,bank_a_00.uk,Olive Garden,2017-11-08,737175.74,-599.13,food,Alice Johnson,CURRENT
ba5b3875-e8a1-4c64-965e-4726e16213a6,bank_a_00.uk,Olive Garden,2017-11-16,736704.65,-471.09,food,Alice Johnson,CURRENT
00d614fe-b67c-49b1-883e-c24601478939,bank_a_00.uk,The Gap,2017-11-16,735781.33,-923.32,clothing,Alice Johnson,CURRENT
9febbb80-ada0-4b82-a021-803cd6c8195e,bank_a_00.uk,Olive Garden,2017-11-20,735100.80,-680.53,food,Alice Johnson,CURRENT
f4fa5df4-bb36-4ae0-87fa-2dc0a827e2ff,bank_a_00.uk,Olive Garden,2017-11-21,734462.81,-637.99,food,Alice Johnson,CURRENT
3b48b140-bdc4-4390-92cf-96bc7a830844,bank_a_00.uk,Registration,2017-11-21,733601.54,-861.27,education,Alice Johnson,CURRENT
3180e043-93cf-4bd2-bab8-8e538ad2d71f,bank_a_00.uk,Netflix,2017-11-23,732829.21,-772.33,entertainment,Alice Johnson,CURRENT
0e9bd61f-b010-432d-bea5-5b621f6cd5a5,bank_a_00.uk,Olive Garden,2017-11-27,732347.66,-481.55,food,Alice Johnson,CURRENT
65490ad9-2c2c-4a2d-b218-c0c5526ef0b5,bank_a_00.uk,AT&T,2017-11-30,729921.86,-2425.80,utility,Alice Johnson,CURRENT
aecb525e-e8b1-4440-901d-1f8eba0387b8,bank_a_00.uk,Dr. Jackson,2017-12-01,728345.61,-1576.25,health,Alice Johnson,CURRENT
fbd30d36-17c0-4951-a1a7-1ac85ad02d12,bank_a_00.uk,K&L Wines,2017-12-01,728075.62,-269.99,gift,Alice Johnson,CURRENT
e6c733a6-e9dc-4bdb-a61b-a426744b7d66,bank_a_00.uk,INCOME,2017-12-03,532588.11,33000.00,INCOME,John Smith,CURRENT
28f984c4-c0e3-4a46-b04a-4a376d61a3f9,bank_a_00.uk,Whole Foods,2017-12-05,532104.65,-483.46,food,John Smith,CURRENT
96053244-938b-4678-a298-5aef2f8ec413,bank_a_00.uk,Walgreen's,2017-12-05,531045.00,-1059.65,health,John Smith,CURRENT
bc0d8611-7686-47c9-89fa-ae638ea63354,bank_a_00.uk,Amazon.com,2017-12-07,530693.70,-351.30,gift,John Smith,CURRENT
d0e619d3-e8dc-4a4f-a43c-5f5b4d0db4c2,bank_a_00.uk,Whole Foods,2017-12-12,530020.47,-673.23,food,John Smith,CURRENT
74a7ebf2-f127-4b06-b681-45d1c3df203d,bank_a_00.uk,The Crucible,2017-12-15,528579.18,-1441.29,education,John Smith,CURRENT
37a2cfb0-c20a-4e27-80a2-04c44ac48f88,bank_a_00.uk,Comcast,2017-12-17,527204.73,-1374.45,utility,John Smith,CURRENT
c75491e5-318d-4c23-814b-9fb362cfe97d,bank_a_00.uk,Jiffy Lube,2017-12-17,525479.35,-1725.38,auto,John Smith,CURRENT
fe5f0465-5a32-4694-bb31-640b8fea9025,bank_a_00.uk,Annual Fee,2017-12-20,524909.12,-570.23,fee,John Smith,CURRENT
68db73f3-cceb-48db-b355-0cf550da3bac,bank_a_00.uk,Whole Foods,2017-12-24,524525.56,-383.56,food,John Smith,CURRENT
de758979-1a4b-4909-8246-822f6d62b69f,bank_a_00.uk,Netflix,2017-12-25,524153.67,-371.89,entertainment,John Smith,CURRENT
2ec5d8ec-31c3-4bdd-ad16-2c518a263b25,bank_a_00.uk,Whole Foods,2017-12-28,523840.77,-312.90,food,John Smith,CURRENT
6ef07e42-d4e4-476f-9a6d-da433e465169,bank_a_00.uk,Banana Republic,2017-12-31,522776.59,-1064.18,clothing,John Smith,CURRENT
50ac4915-8fe6-490e-9875-6eca931e1c20,bank_a_00.uk,Whole Foods,2018-01-02,522129.09,-647.50,food,John Smith,CURRENT
6c17308a-b274-417f-a10e-9fc51878e3ca,bank_a_02.uk,INCOME,2017-12-03,2600000.00,30000.00,INCOME,John Smith,SAVING
d1c22238-b496-4095-a9c2-4de9e24fe69c,bank_a_00.uk,INCOME,2017-12-03,1000000.00,20000.00,INCOME,Alice Johnson,SAVING
cd397499-fb02-4f25-98c4-2dc79346b793,bank_a_00.uk,INCOME,2017-12-03,788075.62,60000.00,INCOME,Alice Johnson,CURRENT
f6a9c1c2-8ec9-45c4-b6ef-c51b6ab6a431,bank_a_00.uk,RENT,2017-12-03,768075.62,-20000.00,RENT,Alice Johnson,CURRENT
deefa5ab-f250-40ab-a089-60cf3d01a412,bank_a_00.uk,Safeway,2017-12-04,767750.74,-324.88,food,Alice Johnson,CURRENT
08a83db2-ebc7-4efb-82cb-1629aaed2751,bank_a_00.uk,K&L Wines,2017-12-04,767247.00,-503.74,gift,Alice Johnson,CURRENT
cb51dc68-e366-4391-a11f-c062da2786c3,bank_a_00.uk,Safeway,2017-12-09,766786.99,-460.01,food,Alice Johnson,CURRENT
6e4f3f56-5414-42d3-b97d-6539fefa72d0,bank_a_00.uk,Safeway,2017-12-12,766459.72,-327.27,food,Alice Johnson,CURRENT
7a66c05d-821c-4083-9a66-cbacad15f8b9,bank_a_00.uk,Safeway,2017-12-16,765979.53,-480.19,food,Alice Johnson,CURRENT
36af44ea-6592-4214-8345-c398f29182a4,bank_a_00.uk,Kenneth Cole,2017-12-17,764511.36,-1468.17,clothing,Alice Johnson,CURRENT
f897537f-c29d-4eee-883e-64023dee6bf9,bank_a_00.uk,Safeway,2017-12-18,763897.49,-613.87,food,Alice Johnson,CURRENT
b25cc3bb-30f5-48a7-a181-ce7a0db8cc60,bank_a_00.uk,Pep Boys,2017-12-19,762855.21,-1042.28,auto,Alice Johnson,CURRENT
1cc8e404-87c0-401e-8777-b7e35341eeb9,bank_a_00.uk,The Crucible,2017-12-19,761816.53,-1038.68,education,Alice Johnson,CURRENT
83c027f1-a86d-4cf3-86b3-cb7eea57628c,bank_a_00.uk,Brinks,2017-12-25,760271.80,-1544.73,utility,Alice Johnson,CURRENT
0ee85d2d-6bd2-4380-9d79-ec22bb416c7a,bank_a_00.uk,Amazon.com,2017-12-25,759819.77,-452.03,entertainment,Alice Johnson,CURRENT
a430ed0b-5406-4ac0-827a-542c8c129300,bank_a_00.uk,Safeway,2017-12-29,759255.22,-564.55,food,Alice Johnson,CURRENT
ac153a70-009e-4cc0-add3-d523839f4873,bank_a_00.uk,Monthly Fee,2017-12-30,758940.42,-314.80,fee,Alice Johnson,CURRENT
a9728db4-22c0-4070-b80d-18113301f799,bank_a_00.uk,INCOME,2018-01-02,555129.09,33000.00,INCOME,John Smith,CURRENT
84dc36d6-5476-40ab-813a-af78a525f3d7,bank_a_00.uk,Whole Foods,2018-01-03,554499.22,-629.87,food,John Smith,CURRENT
69f6e7f3-33b1-4326-88d4-8871475763bc,bank_a_00.uk,The Crucible,2018-01-05,552843.95,-1655.27,education,John Smith,CURRENT
928cd5bd-c6b2-4729-a2bb-0cb4f1a3e58b,bank_a_00.uk,Whole Foods,2018-01-06,552206.22,-637.73,food,John Smith,CURRENT
28671d95-4e91-4d6e-9042-34c66695b912,bank_a_00.uk,Verizon,2018-01-09,550069.50,-2136.72,utility,John Smith,CURRENT
4d331e44-3f7e-4935-9096-0b8d29eb937f,bank_a_00.uk,Macy's,2018-01-12,549283.50,-786.00,clothing,John Smith,CURRENT
d6a13ede-0eac-4597-9e27-25ca373cb7b1,bank_a_00.uk,Rhapsody,2018-01-13,548494.79,-788.71,entertainment,John Smith,CURRENT
f6f986c8-6171-475d-aa2c-a843f0ca2de2,bank_a_00.uk,Nordstrom,2018-01-13,548268.21,-226.58,gift,John Smith,CURRENT
e8ee696f-e645-4282-9fde-872a8d61c43d,bank_a_00.uk,Whole Foods,2018-01-15,547906.67,-361.54,food,John Smith,CURRENT
dc55a12a-e9f8-4620-b62d-87000cc6fd87,bank_a_00.uk,Whole Foods,2018-01-15,547193.02,-713.65,food,John Smith,CURRENT
7ad335bc-0353-429e-afd7-fbcf54feaf1a,bank_a_00.uk,Whole Foods,2018-01-22,546536.74,-656.28,food,John Smith,CURRENT
cbc5feb6-5f36-4b3f-944c-a95ec80657fc,bank_a_02.uk,INCOME,2018-01-02,2630000.00,30000.00,INCOME,John Smith,SAVING
ee0bb342-228a-49b4-9d74-53c04c306f8a,bank_a_00.uk,INCOME,2018-01-02,1020000.00,20000.00,INCOME,Alice Johnson,SAVING
36f03f78-2d32-4834-a372-0b52fddd1da3,bank_a_00.uk,INCOME,2018-01-02,818940.42,60000.00,INCOME,Alice Johnson,CURRENT
462d162a-6540-446c-b837-2c45cacb3981,bank_a_00.uk,RENT,2018-01-02,798940.42,-20000.00,RENT,Alice Johnson,CURRENT
afb4361e-228a-4c30-afe4-ccfb7543a51d,bank_a_00.uk,J. Crew,2018-01-03,797504.33,-1436.09,clothing,Alice Johnson,CURRENT
4cda5c84-afcf-4a88-bde3-77e494030881,bank_a_00.uk,Starbucks,2018-01-04,796810.03,-694.30,food,Alice Johnson,CURRENT
50d0d06f-c1d2-4656-ba77-7695e22858cb,bank_a_00.uk,The Crucible,2018-01-05,795817.21,-992.82,education,Alice Johnson,CURRENT
f5eb4756-6a56-44d3-bb73-98190915a9f5,bank_a_00.uk,Starbucks,2018-01-07,795115.56,-701.65,food,Alice Johnson,CURRENT
9c35d813-a9e4-4ca0-b4d5-53aaaac3d22e,bank_a_00.uk,Netflix,2018-01-09,794492.80,-622.76,entertainment,Alice Johnson,CURRENT
076f8871-32b3-4174-ba32-5a191b11497b,bank_a_00.uk,Starbucks,2018-01-12,794005.47,-487.33,food,Alice Johnson,CURRENT
8149db56-db7d-4f30-9411-825fac236fc8,bank_a_00.uk,AT&T,2018-01-18,792265.51,-1739.96,utility,Alice Johnson,CURRENT
f9dcc759-70ff-4310-ab07-61d3707f47d7,bank_a_00.uk,Starbucks,2018-01-22,791929.28,-336.23,food,Alice Johnson,CURRENT
57c944a9-959b-4387-b704-8e5b7f08a25a,bank_a_00.uk,Dr. Phillips,2018-01-23,790038.18,-1891.10,health,Alice Johnson,CURRENT
69f5a2a0-ebb2-419f-a8f1-edf3feb86cc0,bank_a_00.uk,Arco,2018-01-28,789181.81,-856.37,auto,Alice Johnson,CURRENT
fcb76333-f44e-431c-8098-79b75974d7f6,bank_a_00.uk,Starbucks,2018-01-29,788720.64,-461.17,food,Alice Johnson,CURRENT
68273c2c-86f2-4845-aa67-ec53d2a36548,bank_a_00.uk,Starbucks,2018-02-01,788394.48,-326.16,food,Alice Johnson,CURRENT
1e5012fb-040c-4951-8520-73cc59e16607,bank_a_00.uk,INCOME,2018-02-01,579536.74,33000.00,INCOME,John Smith,CURRENT
8b5d249e-90e0-4994-a08c-c3c250512ee3,bank_a_00.uk,Whole Foods,2018-02-05,579106.56,-430.18,food,John Smith,CURRENT
ffb930f1-0cbc-40bc-8c2e-c8279608610d,bank_a_00.uk,Rhapsody,2018-02-05,578335.26,-771.30,entertainment,John Smith,CURRENT
62c0c78f-090b-414a-8ae3-e40c2c629ca2,bank_a_00.uk,Whole Foods,2018-02-06,577945.37,-389.89,food,John Smith,CURRENT
e7607a1a-635c-4af4-bcd9-0f4350c163a7,bank_a_00.uk,Jiffy Lube,2018-02-06,576933.98,-1011.39,auto,John Smith,CURRENT
1e250dfb-c5e0-4e75-b3df-48812bcb533a,bank_a_00.uk,Nordstrom,2018-02-06,576702.80,-231.18,gift,John Smith,CURRENT
a43eabd3-bfb2-4196-af0e-3da53fde15ff,bank_a_00.uk,Whole Foods,2018-02-07,576223.13,-479.67,food,John Smith,CURRENT
3bb0030c-00be-44fc-a9d5-9e0c0f41ca00,bank_a_00.uk,Wal-Mart,2018-02-08,575240.62,-982.51,health,John Smith,CURRENT
e43478cc-a5ef-47e0-a7ef-79b51afc62a7,bank_a_00.uk,Campus Books,2018-02-16,574378.26,-862.36,education,John Smith,CURRENT
3693c599-e570-46f9-be55-96fc25cf8cf6,bank_a_00.uk,Nordstrom,2018-02-20,573193.67,-1184.59,clothing,John Smith,CURRENT
f9e58d4b-d6ea-46b2-b672-764a62dd209d,bank_a_00.uk,Whole Foods,2018-02-25,572595.06,-598.61,food,John Smith,CURRENT
57f2939c-994d-4445-9954-6b366e8d95f5,bank_a_00.uk,Overlimit Fee,2018-02-26,572070.85,-524.21,fee,John Smith,CURRENT
39bf0d37-9b2d-446e-939b-e5512212f56e,bank_a_00.uk,Whole Foods,2018-03-01,571440.36,-630.49,food,John Smith,CURRENT
2b82a13d-b8ed-4158-8811-afa146d21c5a,bank_a_02.uk,INCOME,2018-02-01,2660000.00,30000.00,INCOME,John Smith,SAVING
0277e8a9-b249-4bac-ba0f-7073a75d87c5,bank_a_00.uk,INCOME,2018-02-01,1040000.00,20000.00,INCOME,Alice Johnson,SAVING
9156418b-7387-4bbf-998a-8fb380e0be8f,bank_a_00.uk,INCOME,2018-02-01,848394.48,60000.00,INCOME,Alice Johnson,CURRENT
580994ba-4d17-4a69-9dbd-fd4540eedb3b,bank_a_00.uk,RENT,2018-02-01,828394.48,-20000.00,RENT,Alice Johnson,CURRENT
d84e587d-570d-4d99-afcd-c38c9afa331d,bank_a_00.uk,Interest Fee,2018-02-02,827895.41,-499.07,fee,Alice Johnson,CURRENT
4d3356b6-6f50-4969-ae26-66a2325ed70a,bank_a_00.uk,AMC Theaters,2018-02-04,827100.83,-794.58,entertainment,Alice Johnson,CURRENT
531f8797-b469-43a3-a9c4-8a8ae35e2836,bank_a_00.uk,Arco,2018-02-15,826129.24,-971.59,auto,Alice Johnson,CURRENT
a30c574d-3527-4631-b76c-ef0392148248,bank_a_00.uk,Brinks,2018-02-21,824980.67,-1148.57,utility,Alice Johnson,CURRENT
ef9ed6bc-0013-46ae-a8b1-a00600a250fe,bank_a_00.uk,Safeway,2018-02-22,824515.53,-465.14,food,Alice Johnson,CURRENT
43d2e2e8-6814-4a6f-b455-76833d4fedba,bank_a_00.uk,Safeway,2018-02-23,824141.94,-373.59,food,Alice Johnson,CURRENT
0f7fcb78-5f46-47b4-9c0e-bb2acb14787c,bank_a_00.uk,Macy's,2018-02-25,823376.11,-765.83,clothing,Alice Johnson,CURRENT
8e2125c7-358d-42cc-816a-be8d8f3f5b8d,bank_a_00.uk,Dr. Roberts,2018-02-25,821925.17,-1450.94,health,Alice Johnson,CURRENT
bb91ac79-499f-47a6-91ac-5c33bdf5f9e5,bank_a_00.uk,Safeway,2018-02-26,821347.90,-577.27,food,Alice Johnson,CURRENT
668beefd-cd49-40f0-ade5-2efee7d77259,bank_a_00.uk,Registration,2018-02-26,820120.11,-1227.79,education,Alice Johnson,CURRENT
1d0bca98-4ef5-4d9c-bae6-468a875d8089,bank_a_00.uk,Amazon.com,2018-02-28,819794.90,-325.21,gift,Alice Johnson,CURRENT
484f19bf-2236-469a-a2b6-189328ef2e89,bank_a_00.uk,Safeway,2018-03-01,819471.55,-323.35,food,Alice Johnson,CURRENT
e9e4d73b-20c6-4f23-be1a-9322b733962f,bank_a_00.uk,INCOME,2018-03-03,604440.36,33000.00,INCOME,John Smith,CURRENT
f11f7efc-b23c-4daf-808b-bf8f1788a63a,bank_a_00.uk,Annual Fee,2018-03-03,604107.86,-332.50,fee,John Smith,CURRENT
8b6f1a8e-17d3-4e9e-8a59-989a82291923,bank_a_00.uk,Dr. Jackson,2018-03-04,603194.77,-913.09,health,John Smith,CURRENT
3a8bb4e4-7985-43ce-8ca4-1c926641bb30,bank_a_00.uk,AMC Theaters,2018-03-05,602514.17,-680.60,entertainment,John Smith,CURRENT
aa66f313-5198-4f85-92ef-70d6d415309a,bank_a_00.uk,Trader Joe's,2018-03-07,601878.69,-635.48,food,John Smith,CURRENT
e802ce62-34c6-4b91-af23-2999e6de2e69,bank_a_00.uk,Trader Joe's,2018-03-07,601455.22,-423.47,food,John Smith,CURRENT
69dd4a2d-7fc4-4711-92f3-a85bf091f850,bank_a_00.uk,Trader Joe's,2018-03-09,600903.49,-551.73,food,John Smith,CURRENT
a48a35fc-6d36-4aeb-961f-65cedc8fa6bd,bank_a_00.uk,,2018-03-10,599442.34,-1461.15,utility,John Smith,CURRENT
94db9a55-d6c0-444a-a272-496914e9e8be,bank_a_00.uk,Trader Joe's,2018-03-13,598890.48,-551.86,food,John Smith,CURRENT
98662b9d-9c02-4ffd-85c5-1d3f3df6c03c,bank_a_00.uk,Trader Joe's,2018-03-17,598201.53,-688.95,food,John Smith,CURRENT
0985523f-b9c8-47f8-8c74-c89d8d663076,bank_a_00.uk,The Crucible,2018-03-18,596637.75,-1563.78,education,John Smith,CURRENT
806d040f-f312-4012-87ee-db39d3790dde,bank_a_00.uk,Apple Store,2018-03-23,596290.30,-347.45,gift,John Smith,CURRENT
2db6e46b-a63a-47b6-ba09-6720f5b5bddd,bank_a_00.uk,Kenneth Cole,2018-03-24,595094.62,-1195.68,clothing,John Smith,CURRENT
45d90b26-5d28-4b09-bbec-11e8e20614fd,bank_a_00.uk,Trader Joe's,2018-03-30,594618.46,-476.16,food,John Smith,CURRENT
f4e7844d-93fd-4fb8-bcde-21227c5759e9,bank_a_00.uk,Union 76,2018-04-01,592825.61,-1792.85,auto,John Smith,CURRENT
02d38a51-b303-44c9-b510-d22b172a52bf,bank_a_02.uk,INCOME,2018-03-03,2690000.00,30000.00,INCOME,John Smith,SAVING
a26d3157-809d-4895-8e9c-d2c6523523a8,bank_a_00.uk,INCOME,2018-03-03,1060000.00,20000.00,INCOME,Alice Johnson,SAVING
ec68f1c5-09af-4bff-aa2d-205d0a085d07,bank_a_00.uk,INCOME,2018-03-03,879471.55,60000.00,INCOME,Alice Johnson,CURRENT
6d5965e5-2b30-4a6d-8964-8a43df6bd472,bank_a_00.uk,Tuition,2018-03-03,878445.87,-1025.68,education,Alice Johnson,CURRENT
d705fdab-2b35-45e6-a9b1-b760b43b63cf,bank_a_00.uk,RENT,2018-03-03,858445.87,-20000.00,RENT,Alice Johnson,CURRENT
d924f294-3799-478e-856a-5bf44868df3e,bank_a_00.uk,Starbucks,2018-03-05,857787.47,-658.40,food,Alice Johnson,CURRENT
77bb48b7-1964-4ff4-89bb-0ced2b160731,bank_a_00.uk,Overlimit Fee,2018-03-06,857300.20,-487.27,fee,Alice Johnson,CURRENT
e16e40dd-3203-4e3f-b6ad-b6e2f10df812,bank_a_00.uk,Starbucks,2018-03-07,856890.55,-409.65,food,Alice Johnson,CURRENT
0cf3b641-a92b-4c58-aefc-c17093163df8,bank_a_00.uk,Starbucks,2018-03-08,856457.58,-432.97,food,Alice Johnson,CURRENT
fc4461fc-1de9-437b-a002-dfedb57159d1,bank_a_00.uk,Starbucks,2018-03-08,855815.92,-641.66,food,Alice Johnson,CURRENT
84b224f4-44bc-465e-9758-5d7d20c58a1e,bank_a_00.uk,K&L Wines,2018-03-08,855532.54,-283.38,gift,Alice Johnson,CURRENT
77eeb5df-72c8-428d-8867-47153efa1496,bank_a_00.uk,Netflix,2018-03-15,855006.59,-525.95,entertainment,Alice Johnson,CURRENT
bb2d0cf3-4a52-4771-a1ec-499eca375779,bank_a_00.uk,Union 76,2018-03-17,853352.49,-1654.10,auto,Alice Johnson,CURRENT
cb64501a-adc1-4ae0-8538-32d35ad030fe,bank_a_00.uk,Starbucks,2018-03-22,852960.37,-392.12,food,Alice Johnson,CURRENT
25c68752-c7e4-481d-a1ae-577e00e85360,bank_a_00.uk,The Gap,2018-03-26,851931.31,-1029.06,clothing,Alice Johnson,CURRENT
08c3f646-3c7b-486f-8379-b4b1ff46d715,bank_a_00.uk,Brinks,2018-03-29,850116.30,-1815.01,utility,Alice Johnson,CURRENT
db5d0323-5e54-40bc-a0a3-8d82c4cfc5a7,bank_a_00.uk,Starbucks,2018-04-02,849626.32,-489.98,food,Alice Johnson,CURRENT
c84f1b38-ab1f-49d9-a23e-0f6b276fe6a5,bank_a_00.uk,INCOME,2018-04-02,625825.61,33000.00,INCOME,John Smith,CURRENT
a99d8ea1-6939-4341-8f96-ba1aad43e467,bank_a_00.uk,Whole Foods,2018-04-02,625269.03,-556.58,food,John Smith,CURRENT
8cffc5da-172f-405d-8ab9-8a2a40b23338,bank_a_00.uk,Registration,2018-04-05,623542.67,-1726.36,education,John Smith,CURRENT
64f7704a-f111-45be-acdd-6d1d07f646d5,bank_a_00.uk,Amazon.com,2018-04-06,622815.01,-727.66,entertainment,John Smith,CURRENT
91e35792-add2-4cf0-a707-2e313f523e30,bank_a_00.uk,Union 76,2018-04-12,621367.69,-1447.32,auto,John Smith,CURRENT
70484714-543a-4b1d-af56-163764df5391,bank_a_00.uk,The Gap,2018-04-14,619881.26,-1486.43,clothing,John Smith,CURRENT
00c4c92d-0842-4cd2-b125-e4e58b554585,bank_a_00.uk,Walgreen's,2018-04-15,618941.64,-939.62,health,John Smith,CURRENT
5aa75e5b-7b21-419f-b5cc-41917d83f665,bank_a_00.uk,Neiman-Marcus,2018-04-15,618668.57,-273.07,gift,John Smith,CURRENT
95452735-a644-4490-bad3-6e24e33eae06,bank_a_00.uk,Whole Foods,2018-04-16,618183.86,-484.71,food,John Smith,CURRENT
ae3ff608-4ca7-4665-9e33-9d3e08fa0c2e,bank_a_00.uk,Whole Foods,2018-04-23,617863.88,-319.98,food,John Smith,CURRENT
de1774c4-8d12-4843-849c-45451b9537f6,bank_a_00.uk,Whole Foods,2018-04-26,617418.55,-445.33,food,John Smith,CURRENT
45a8102c-12ff-47cc-816c-f787de646d98,bank_a_02.uk,INCOME,2018-04-02,2720000.00,30000.00,INCOME,John Smith,SAVING
2349915c-848c-44ce-8ace-6505cc973ac4,bank_a_00.uk,INCOME,2018-04-02,1080000.00,20000.00,INCOME,Alice Johnson,SAVING
57b826d9-ee91-44a9-a06c-6d40d27a15ef,bank_a_00.uk,INCOME,2018-04-02,909626.32,60000.00,INCOME,Alice Johnson,CURRENT
8a6796d9-4193-4722-8797-4000641e74fe,bank_a_00.uk,RENT,2018-04-02,889626.32,-20000.00,RENT,Alice Johnson,CURRENT
09a3cf5a-00af-49e2-980b-1c92cc8461b3,bank_a_00.uk,In-N-Out Burger,2018-04-06,889125.79,-500.53,food,Alice Johnson,CURRENT
92e83bf6-4b5f-4ae2-8e2e-defe246639be,bank_a_00.uk,In-N-Out Burger,2018-04-07,888522.26,-603.53,food,Alice Johnson,CURRENT
0cd1f656-4c70-4ce9-b70c-a4d189e8946c,bank_a_00.uk,Netflix,2018-04-12,888035.96,-486.30,entertainment,Alice Johnson,CURRENT
6a66f80e-ea08-4871-a759-49cb08f4b7c0,bank_a_00.uk,In-N-Out Burger,2018-04-14,887405.35,-630.61,food,Alice Johnson,CURRENT
bd56f42e-800c-45c3-a17e-9ebea183a7f0,bank_a_00.uk,In-N-Out Burger,2018-04-15,886963.30,-442.05,food,Alice Johnson,CURRENT
62e98086-830a-4091-b388-046525c31880,bank_a_00.uk,Amazon.com,2018-04-15,885385.13,-1578.17,education,Alice Johnson,CURRENT
2648d548-a3b0-41e7-b221-e98295b66ed4,bank_a_00.uk,Bank Fee,2018-04-15,884942.35,-442.78,fee,Alice Johnson,CURRENT
7bd1e98f-d555-4d11-be4e-cffc6eae9126,bank_a_00.uk,In-N-Out Burger,2018-04-20,884523.88,-418.47,food,Alice Johnson,CURRENT
e5dcedb4-9ead-486f-9f3d-0752b3241abf,bank_a_00.uk,Banana Republic,2018-04-24,883474.51,-1049.37,clothing,Alice Johnson,CURRENT
5b1f9de3-7276-47eb-a7f2-c071e037a659,bank_a_00.uk,Chevron,2018-04-25,881715.27,-1759.24,auto,Alice Johnson,CURRENT
83ccb377-ea14-4929-9b8c-d1e13cfd5324,bank_a_00.uk,In-N-Out Burger,2018-05-01,881265.25,-450.02,food,Alice Johnson,CURRENT
dbccc3f2-d495-4a9a-9a0f-21da2e867a61,bank_a_00.uk,INCOME,2018-05-02,650418.55,33000.00,INCOME,John Smith,CURRENT
3c926374-5852-4ca9-90b9-e83d8eb73a93,bank_a_00.uk,K&L Wines,2018-05-04,649985.81,-432.74,gift,John Smith,CURRENT
e11b930c-a182-43f6-b3d7-6744e7545895,bank_a_00.uk,Olive Garden,2018-05-05,649434.05,-551.76,food,John Smith,CURRENT
010f6743-aa65-4169-aa0c-69e100247150,bank_a_00.uk,Dr. Jackson,2018-05-06,648428.32,-1005.73,health,John Smith,CURRENT
698dfe41-1e40-4d02-936b-e765e5b8de38,bank_a_00.uk,Bank Fee,2018-05-09,648124.04,-304.28,fee,John Smith,CURRENT
6f72f11f-ce80-4eef-a685-206afda5daae,bank_a_00.uk,Olive Garden,2018-05-12,647809.49,-314.55,food,John Smith,CURRENT
96c228c2-bfe6-48c7-b75a-5335364d627e,bank_a_00.uk,Olive Garden,2018-05-12,647411.85,-397.64,food,John Smith,CURRENT
d76109b0-ca36-4f6a-bd5c-7ac5ff9e7c80,bank_a_00.uk,Olive Garden,2018-05-14,646994.39,-417.46,food,John Smith,CURRENT
50b51b46-c8fc-41e3-98ee-0f61692db85a,bank_a_00.uk,Banana Republic,2018-05-19,645561.44,-1432.95,clothing,John Smith,CURRENT
14c3c253-6af6-4b75-a6cc-591eab7a0617,bank_a_00.uk,AMC Theaters,2018-05-21,645000.80,-560.64,entertainment,John Smith,CURRENT
ed2fd1de-91bc-4ee5-a4c1-dd838d92ded5,bank_a_00.uk,Olive Garden,2018-05-30,644382.25,-618.55,food,John Smith,CURRENT
25e36527-356d-47e0-9bd8-cf9bd2a2f15c,bank_a_00.uk,AT&T,2018-06-01,643018.97,-1363.28,utility,John Smith,CURRENT
6a71ad5b-6782-4bb3-8638-12e854536e18,bank_a_00.uk,Union 76,2018-06-01,641701.96,-1317.01,auto,John Smith,CURRENT
745fa566-ac1e-4ef7-bf4d-dc23a8a30658,bank_a_02.uk,INCOME,2018-05-02,2750000.00,30000.00,INCOME,John Smith,SAVING
aedff0d2-ce8d-4e2e-af24-c787da9f010f,bank_a_00.uk,INCOME,2018-05-02,1100000.00,20000.00,INCOME,Alice Johnson,SAVING
500e3c6c-17bc-44e5-aec4-83d7f4077cae,bank_a_00.uk,INCOME,2018-05-02,941265.25,60000.00,INCOME,Alice Johnson,CURRENT
a0094d71-2b81-4884-86df-843520ee9d31,bank_a_00.uk,RENT,2018-05-02,921265.25,-20000.00,RENT,Alice Johnson,CURRENT
537d08ff-6074-4075-8c2b-82a1343c576f,bank_a_00.uk,Dr. Martins,2018-05-03,920088.01,-1177.24,health,Alice Johnson,CURRENT
e649a2a1-0bcc-4c05-aede-be52852ef2ab,bank_a_00.uk,Apple Store,2018-05-03,919850.70,-237.31,gift,Alice Johnson,CURRENT
6e942f3e-4ecd-4658-a559-2b40df06ba00,bank_a_00.uk,Interest Fee,2018-05-05,919349.23,-501.47,fee,Alice Johnson,CURRENT
527deb9a-7ce7-4580-91d1-514fe16db2c9,bank_a_00.uk,The Crucible,2018-05-09,918042.07,-1307.16,education,Alice Johnson,CURRENT
88e27eab-1bc2-4dc4-84f0-310b822c06f2,bank_a_00.uk,AMC Theaters,2018-05-13,917572.58,-469.49,entertainment,Alice Johnson,CURRENT
78421fee-c4b3-45b4-9722-c60f5b6c81a7,bank_a_00.uk,Kenneth Cole,2018-05-15,916819.91,-752.67,clothing,Alice Johnson,CURRENT
dc654c89-1fb1-4f65-8bc9-51191b2b6a3b,bank_a_00.uk,,2018-05-18,914341.53,-2478.38,utility,Alice Johnson,CURRENT
e44f8755-0b6a-4d20-aa33-777f55c6bf31,bank_a_00.uk,Safeway,2018-05-20,913999.20,-342.33,food,Alice Johnson,CURRENT
21c65610-f13f-4fb5-bc62-0944df9744e5,bank_a_00.uk,Safeway,2018-05-23,913426.71,-572.49,food,Alice Johnson,CURRENT
11a83237-b841-4dbd-a2da-8eca78b9ae4d,bank_a_00.uk,Safeway,2018-05-26,912908.00,-518.71,food,Alice Johnson,CURRENT
eea9ee94-960e-402b-b6c9-d96d3e8bff9e,bank_a_00.uk,Safeway,2018-05-27,912201.12,-706.88,food,Alice Johnson,CURRENT
096215ce-b85c-431f-b6fd-b8c01b4e59bf,bank_a_00.uk,Safeway,2018-05-29,911747.01,-454.11,food,Alice Johnson,CURRENT
83012a3f-9360-413c-b570-b9dfd681e4da,bank_a_00.uk,Safeway,2018-06-01,911039.42,-707.59,food,Alice Johnson,CURRENT
0b70172d-0192-4a55-a488-11e274d0e7d2,bank_a_00.uk,INCOME,2018-06-01,674701.96,33000.00,INCOME,John Smith,CURRENT
e0da050d-0520-41e1-b166-2eb5776cc439,bank_a_00.uk,In-N-Out Burger,2018-06-07,674232.61,-469.35,food,John Smith,CURRENT
7f56b2bc-f8e2-4b70-b7b7-620d456c78ff,bank_a_00.uk,In-N-Out Burger,2018-06-10,673550.57,-682.04,food,John Smith,CURRENT
9b309570-4a51-499b-9ee2-1983b60a376f,bank_a_00.uk,In-N-Out Burger,2018-06-12,673065.44,-485.13,food,John Smith,CURRENT
6c502741-e106-4891-bdfd-fb7fe5d8a761,bank_a_00.uk,In-N-Out Burger,2018-06-14,672694.02,-371.42,food,John Smith,CURRENT
b174b1c2-18f1-4458-9f3f-489b779799f5,bank_a_00.uk,Tuition,2018-06-14,670990.57,-1703.45,education,John Smith,CURRENT
55f6cd7c-d5fb-4f4c-9005-b904003ec90e,bank_a_00.uk,In-N-Out Burger,2018-06-15,670378.41,-612.16,food,John Smith,CURRENT
c445acf7-8602-4d37-a01c-bed7787b8a8d,bank_a_00.uk,In-N-Out Burger,2018-06-17,669874.35,-504.06,food,John Smith,CURRENT
6140089f-ba76-43e6-b48a-e613b31bd34c,bank_a_00.uk,Netflix,2018-06-17,669094.58,-779.77,entertainment,John Smith,CURRENT
f65464d4-7747-442c-9958-4a58620e6e9b,bank_a_00.uk,Kenneth Cole,2018-06-23,667546.16,-1548.42,clothing,John Smith,CURRENT
9e92fb0a-241d-460c-a2c3-626a76dbb29f,bank_a_00.uk,Brinks,2018-06-24,665501.44,-2044.72,utility,John Smith,CURRENT
3f25d777-d93c-4fe0-a4ff-d3216f8156ce,bank_a_00.uk,Union 76,2018-06-29,664374.59,-1126.85,auto,John Smith,CURRENT
bb2dc9ef-e932-4e07-97ca-25887f3b6ed5,bank_a_00.uk,Wal-Mart,2018-07-01,663452.85,-921.74,health,John Smith,CURRENT
7b7fdded-2896-4d7a-bd01-07f40e0f4833,bank_a_00.uk,Neiman-Marcus,2018-07-01,663046.24,-406.61,gift,John Smith,CURRENT
e87ec2d7-11db-4864-acdb-62cf1f07ea3a,bank_a_02.uk,INCOME,2018-06-01,2780000.00,30000.00,INCOME,John Smith,SAVING
e58f57ec-9801-4dc4-965b-628ddfa249cf,bank_a_00.uk,INCOME,2018-06-01,1120000.00,20000.00,INCOME,Alice Johnson,SAVING
1a7e50ed-ec13-4940-9782-fefdf01caea5,bank_a_00.uk,INCOME,2018-06-01,971039.42,60000.00,INCOME,Alice Johnson,CURRENT
3bebd6c6-cdbc-41fa-93d3-b45dbaced0ee,bank_a_00.uk,RENT,2018-06-01,951039.42,-20000.00,RENT,Alice Johnson,CURRENT
50ab2b84-4924-4663-87d8-7aa1edacb44b,bank_a_00.uk,Netflix,2018-06-04,950217.51,-821.91,entertainment,Alice Johnson,CURRENT
87a208ec-d9a7-412f-9be1-c49c01f51a58,bank_a_00.uk,Shell,2018-06-05,948257.42,-1960.09,auto,Alice Johnson,CURRENT
5588b999-edd8-4320-92c7-19792889e3ce,bank_a_00.uk,Safeway,2018-06-09,947612.70,-644.72,food,Alice Johnson,CURRENT
0871e676-6cdd-424a-bf7c-1ebaf2de12bb,bank_a_00.uk,Nordstrom,2018-06-12,946760.88,-851.82,clothing,Alice Johnson,CURRENT
aa95cf65-1790-4721-86ad-ba2f869d2aa3,bank_a_00.uk,Safeway,2018-06-13,946101.35,-659.53,food,Alice Johnson,CURRENT
c708affb-a283-49d2-8a50-25f35ead6253,bank_a_00.uk,Safeway,2018-06-16,945452.35,-649.00,food,Alice Johnson,CURRENT
86b54b52-63e3-46eb-b91d-a648191dd906,bank_a_00.uk,Safeway,2018-06-16,944862.54,-589.81,food,Alice Johnson,CURRENT
829c1c3d-7267-4c62-93b3-3d563959b510,bank_a_00.uk,Dr. Phillips,2018-06-18,943982.34,-880.20,health,Alice Johnson,CURRENT
d5f696ce-0e60-437f-8c15-42596a76b6b1,bank_a_00.uk,Annual Fee,2018-06-21,943629.23,-353.11,fee,Alice Johnson,CURRENT
b7d09ddb-619d-49d5-aeea-2f9462ddca84,bank_a_00.uk,Safeway,2018-06-25,942986.83,-642.40,food,Alice Johnson,CURRENT
bd5699d3-2aca-4040-9c05-e6ecf3e05d67,bank_a_00.uk,Tuition,2018-06-25,941380.91,-1605.92,education,Alice Johnson,CURRENT
ea6dbcd9-053e-43cd-8d5b-9e3903f9ab91,bank_a_00.uk,INCOME,2018-07-01,696046.24,33000.00,INCOME,John Smith,CURRENT
444ce9eb-92bd-46f3-bb2c-64be9c36dd16,bank_a_00.uk,Olive Garden,2018-07-01,695520.33,-525.91,food,John Smith,CURRENT
c6a41a23-5eeb-4ad3-9578-2ced18ada6bb,bank_a_00.uk,Olive Garden,2018-07-01,694848.41,-671.92,food,John Smith,CURRENT
a11144ac-7386-416e-a6fe-3c27a4383447,bank_a_00.uk,K&L Wines,2018-07-01,694606.58,-241.83,gift,John Smith,CURRENT
ebf05cfb-18c0-49a8-8c26-b82dc667d35c,bank_a_00.uk,Olive Garden,2018-07-02,694259.68,-346.90,food,John Smith,CURRENT
df1746ae-b7f8-421b-bb6a-bb5013ca4f4f,bank_a_00.uk,Walgreen's,2018-07-02,692372.59,-1887.09,health,John Smith,CURRENT
ff8b29fd-a652-4b5f-81de-c8f0908b18aa,bank_a_00.uk,Chevron,2018-07-06,690777.89,-1594.70,auto,John Smith,CURRENT
9c197342-842f-450f-9277-a52a47001486,bank_a_00.uk,Olive Garden,2018-07-07,690432.29,-345.60,food,John Smith,CURRENT
b8d5842e-d276-413f-9b62-efa4f30d0981,bank_a_00.uk,AT&T,2018-07-10,687984.98,-2447.31,utility,John Smith,CURRENT
2f7a8a16-7bea-4789-a270-9138d3bdd529,bank_a_00.uk,AMC Theaters,2018-07-18,687206.19,-778.79,entertainment,John Smith,CURRENT
5c5b99b1-589c-47e8-9c44-a42175d2deb9,bank_a_00.uk,J. Crew,2018-07-21,686377.78,-828.41,clothing,John Smith,CURRENT
e1d7695e-62c5-4a51-b518-56f86c49dbb1,bank_a_00.uk,Olive Garden,2018-07-23,686053.70,-324.08,food,John Smith,CURRENT
1e4e379a-8d96-4570-b01f-b459ba2fcd05,bank_a_00.uk,Olive Garden,2018-07-23,685646.12,-407.58,food,John Smith,CURRENT
fea92e74-d5f4-48df-9d81-62f6a4aa71ca,bank_a_00.uk,Amazon.com,2018-07-30,684433.66,-1212.46,education,John Smith,CURRENT
27763557-9fb2-4927-bc6a-f0e5de68791b,bank_a_02.uk,INCOME,2018-07-01,2810000.00,30000.00,INCOME,John Smith,SAVING
3a14b6fa-42be-46bc-92aa-94aa8ebe3d39,bank_a_00.uk,INCOME,2018-07-01,1140000.00,20000.00,INCOME,Alice Johnson,SAVING
29f055d2-ef58-4527-9a44-300992f526c9,bank_a_00.uk,INCOME,2018-07-01,1001380.91,60000.00,INCOME,Alice Johnson,CURRENT
8354f653-fcf7-45f6-8bfd-9f6e579fbcd3,bank_a_00.uk,J. Crew,2018-07-01,1000489.79,-891.12,clothing,Alice Johnson,CURRENT
b0abf910-9bc6-4938-99aa-c0084d8e3eed,bank_a_00.uk,The Crucible,2018-07-01,998780.86,-1708.93,education,Alice Johnson,CURRENT
8c06afda-b38c-4171-bb6f-c9d57e4fdab7,bank_a_00.uk,Bank Fee,2018-07-01,998275.55,-505.31,fee,Alice Johnson,CURRENT
ba04c25b-d6aa-43ec-a5c8-060186894521,bank_a_00.uk,RENT,2018-07-01,978275.55,-20000.00,RENT,Alice Johnson,CURRENT
15fa8140-567c-420a-bd22-1e33f37a5732,bank_a_00.uk,Trader Joe's,2018-07-03,977935.03,-340.52,food,Alice Johnson,CURRENT
9b16d337-d264-40d8-a589-0e6bc3ef3e49,bank_a_00.uk,Jiffy Lube,2018-07-07,976385.84,-1549.19,auto,Alice Johnson,CURRENT
0631cd41-bfb6-497b-94d6-46967cfa9919,bank_a_00.uk,Trader Joe's,2018-07-10,975780.99,-604.85,food,Alice Johnson,CURRENT
8dc5c80b-3bf0-4e77-b310-80b42adc6b83,bank_a_00.uk,Apple Store,2018-07-10,975290.59,-490.40,gift,Alice Johnson,CURRENT
330d07f5-0075-45f0-92cf-d3f305f88721,bank_a_00.uk,Trader Joe's,2018-07-14,974873.76,-416.83,food,Alice Johnson,CURRENT
43c948b4-a497-423e-9c5a-68be6a120ddf,bank_a_00.uk,Trader Joe's,2018-07-15,974501.07,-372.69,food,Alice Johnson,CURRENT
2a38e317-c78f-4dea-95e6-84448484cebf,bank_a_00.uk,Trader Joe's,2018-07-20,974174.00,-327.07,food,Alice Johnson,CURRENT
70478222-07a1-4418-a179-ef3bf30f55d8,bank_a_00.uk,Netflix,2018-07-23,973531.69,-642.31,entertainment,Alice Johnson,CURRENT
ccb7f66e-3a8f-4e7a-8a92-545b0035884b,bank_a_00.uk,Dr. Roberts,2018-07-24,971951.92,-1579.77,health,Alice Johnson,CURRENT
f889a6a9-9767-40ad-84fe-46f7c880ed05,bank_a_00.uk,Trader Joe's,2018-07-29,971413.69,-538.23,food,Alice Johnson,CURRENT
ea2cb883-adc1-4814-b2b6-7de62fbb62aa,bank_a_00.uk,Verizon,2018-07-29,969415.56,-1998.13,utility,Alice Johnson,CURRENT
a5d50478-a2bb-4cd0-8055-ee32f1fee932,bank_a_00.uk,INCOME,2018-07-31,717433.66,33000.00,INCOME,John Smith,CURRENT
2ea34cfe-5207-42a3-8676-b6792a928723,bank_a_00.uk,AMC Theaters,2018-07-31,716604.90,-828.76,entertainment,John Smith,CURRENT
fc99a625-5d11-4004-a37f-14383bc3e2b5,bank_a_00.uk,Whole Foods,2018-08-01,716237.64,-367.26,food,John Smith,CURRENT
fb3a15e8-9c6a-4d50-aa83-fd005e359bc7,bank_a_00.uk,Apple Store,2018-08-01,715786.26,-451.38,gift,John Smith,CURRENT
f1a3ac03-8392-4171-b93b-e8a2e4da7229,bank_a_00.uk,Whole Foods,2018-08-04,715164.22,-622.04,food,John Smith,CURRENT
f7ea4e54-7074-4339-abc0-352db931cc46,bank_a_00.uk,Arco,2018-08-05,713891.36,-1272.86,auto,John Smith,CURRENT
ecd3bbf0-ea01-4653-8b29-416814c5bdbe,bank_a_00.uk,Whole Foods,2018-08-14,713366.51,-524.85,food,John Smith,CURRENT
13c6beed-7906-4805-b9d9-aa582b0b4c4d,bank_a_00.uk,Whole Foods,2018-08-15,712894.42,-472.09,food,John Smith,CURRENT
e02a9c0d-9b6a-491c-8c65-158c3e5d11d1,bank_a_00.uk,Late Fee,2018-08-16,712388.41,-506.01,fee,John Smith,CURRENT
91ec1f5b-7de9-41fc-a472-8ba0a2d24871,bank_a_00.uk,Walgreen's,2018-08-18,710639.73,-1748.68,health,John Smith,CURRENT
b1be22cf-8d7c-4f6e-84a1-1dc6967739bb,bank_a_00.uk,Brinks,2018-08-24,708364.75,-2274.98,utility,John Smith,CURRENT
4b217dcf-cae5-4732-b85c-76d52fc70892,bank_a_00.uk,Whole Foods,2018-08-29,707955.86,-408.89,food,John Smith,CURRENT
08161dd5-8660-4909-886a-e3fcf9032aa2,bank_a_00.uk,Macy's,2018-08-29,706666.44,-1289.42,clothing,John Smith,CURRENT
06b8c702-2dd5-492e-a704-af76c99e77ce,bank_a_00.uk,Amazon.com,2018-08-30,705195.91,-1470.53,education,John Smith,CURRENT
b7e488cf-e9b7-479a-b34c-8df44d782b97,bank_a_02.uk,INCOME,2018-07-31,2840000.00,30000.00,INCOME,John Smith,SAVING
75a48f7c-9b32-4c90-8a36-88a62125df19,bank_a_00.uk,INCOME,2018-07-31,1160000.00,20000.00,INCOME,Alice Johnson,SAVING
a6e55e1b-21c5-4efc-8423-f59b55409e84,bank_a_00.uk,INCOME,2018-07-31,1029415.56,60000.00,INCOME,Alice Johnson,CURRENT
d335d91e-a445-4788-908e-e83654a72f17,bank_a_00.uk,The Crucible,2018-07-31,1027900.59,-1514.97,education,Alice Johnson,CURRENT
1ed0cf2e-8e17-4a0b-89a6-d1f5ca7e9fc6,bank_a_00.uk,RENT,2018-07-31,1007900.59,-20000.00,RENT,Alice Johnson,CURRENT
aba06b71-70b8-4b76-9ae1-e2aebc9ddb3b,bank_a_00.uk,Trader Joe's,2018-08-04,1007200.73,-699.86,food,Alice Johnson,CURRENT
d5f7456c-e4d8-47b2-b02f-b79958baaa51,bank_a_00.uk,Trader Joe's,2018-08-04,1006724.72,-476.01,food,Alice Johnson,CURRENT
8956911b-cc9c-4fa7-84ee-7a4caca6e05f,bank_a_00.uk,Neiman-Marcus,2018-08-04,1006250.21,-474.51,gift,Alice Johnson,CURRENT
bbdfad98-66e9-4473-b80d-9acd7255d529,bank_a_00.uk,The Gap,2018-08-08,1004756.45,-1493.76,clothing,Alice Johnson,CURRENT
91cd0208-e523-464a-9a2c-11b59fdb4239,bank_a_00.uk,Netflix,2018-08-12,1004335.23,-421.22,entertainment,Alice Johnson,CURRENT
69c4d662-8560-45a2-8e21-9ebd7f3b52f2,bank_a_00.uk,Trader Joe's,2018-08-13,1003643.56,-691.67,food,Alice Johnson,CURRENT
1d5e3813-c93b-41c2-9092-a492f30883f6,bank_a_00.uk,AT&T,2018-08-19,1001125.17,-2518.39,utility,Alice Johnson,CURRENT
6b43d6fc-a347-482b-8fd7-9da639c6f25f,bank_a_00.uk,Overlimit Fee,2018-08-23,1000623.77,-501.40,fee,Alice Johnson,CURRENT
9999c763-64a0-46d1-bce6-23fa94a63c8f,bank_a_00.uk,Trader Joe's,2018-08-27,999938.77,-685.00,food,Alice Johnson,CURRENT
0a9340ea-8a1c-4e5b-9ea6-85060e38a6fa,bank_a_00.uk,Dr. Jackson,2018-08-28,998699.90,-1238.87,health,Alice Johnson,CURRENT
34f358eb-c193-4483-99b4-d8dff9bc4626,bank_a_00.uk,Pep Boys,2018-08-29,996785.10,-1914.80,auto,Alice Johnson,CURRENT
4b85dda9-820e-4ff0-a39f-dd858a57a8fe,bank_a_00.uk,INCOME,2018-08-30,738195.91,33000.00,INCOME,John Smith,CURRENT
7a3914fd-6c13-4e43-9128-8308a3649e20,bank_a_00.uk,In-N-Out Burger,2018-08-30,737590.85,-605.06,food,John Smith,CURRENT
26ae1116-876e-4ceb-87d0-9d29f6b13838,bank_a_00.uk,In-N-Out Burger,2018-08-31,737266.94,-323.91,food,John Smith,CURRENT
590c778d-a8a6-4ff5-b609-36a2686a9ca9,bank_a_00.uk,Registration,2018-08-31,735804.89,-1462.05,education,John Smith,CURRENT
26207f44-c540-4a98-93c6-695971e0180a,bank_a_00.uk,J. Crew,2018-09-02,734944.71,-860.18,clothing,John Smith,CURRENT
2bcbdbf7-bfe5-4e7d-ab7b-c8d13d3b34f5,bank_a_00.uk,In-N-Out Burger,2018-09-04,734415.76,-528.95,food,John Smith,CURRENT
8a13fcd3-3bc2-4e48-aa26-b133e11f8cf8,bank_a_00.uk,In-N-Out Burger,2018-09-10,733810.98,-604.78,food,John Smith,CURRENT
816b25e3-432d-4e94-b3d9-d76e04962ae5,bank_a_00.uk,Rhapsody,2018-09-12,733405.85,-405.13,entertainment,John Smith,CURRENT
78116f2a-8b72-42af-86b2-fef83e0b661e,bank_a_00.uk,Comcast,2018-09-15,731605.59,-1800.26,utility,John Smith,CURRENT
902b9ebd-8574-4221-834f-88eac80947ec,bank_a_00.uk,Apple Store,2018-09-15,731216.94,-388.65,gift,John Smith,CURRENT
cbf9e371-8222-421a-a18f-ea6e4a97a4c7,bank_a_00.uk,Chevron,2018-09-17,729427.23,-1789.71,auto,John Smith,CURRENT
65120ca0-108b-4dfb-9093-925197e35666,bank_a_00.uk,In-N-Out Burger,2018-09-19,729048.13,-379.10,food,John Smith,CURRENT
0b9da05e-ad7a-490b-b5dc-f44ec6547d92,bank_a_00.uk,In-N-Out Burger,2018-09-22,728396.11,-652.02,food,John Smith,CURRENT
1116b8eb-c0aa-4609-ac7a-1eab1a73a876,bank_a_00.uk,Dr. Martins,2018-09-28,726757.28,-1638.83,health,John Smith,CURRENT
e3dfca30-1deb-4949-8b8e-85b8c1401f68,bank_a_00.uk,Interest Fee,2018-09-29,726474.43,-282.85,fee,John Smith,CURRENT
2ec32a59-6abd-4e74-b050-cd0227dbff58,bank_a_02.uk,INCOME,2018-08-30,2870000.00,30000.00,INCOME,John Smith,SAVING
15308e6c-c5d4-4a7a-badc-3cea945fc48c,bank_a_00.uk,INCOME,2018-08-30,1180000.00,20000.00,INCOME,Alice Johnson,SAVING
d09af34c-5dd7-4526-bc73-f0052d10bc52,bank_a_00.uk,INCOME,2018-08-30,1056785.10,60000.00,INCOME,Alice Johnson,CURRENT
98e22678-5f5f-4e1b-92eb-9911085aaa17,bank_a_00.uk,RENT,2018-08-30,1036785.10,-20000.00,RENT,Alice Johnson,CURRENT
77598277-f69a-472b-90e6-e941b44fd562,bank_a_00.uk,Nordstrom,2018-09-03,1035692.76,-1092.34,clothing,Alice Johnson,CURRENT
8d38b30f-eebc-4762-9820-110eae15bcfa,bank_a_00.uk,Trader Joe's,2018-09-06,1035063.75,-629.01,food,Alice Johnson,CURRENT
45ff59d8-6e7a-402e-b631-c4f578a3ff5c,bank_a_00.uk,Trader Joe's,2018-09-06,1034539.01,-524.74,food,Alice Johnson,CURRENT
d178a83a-43d1-4fd7-b55b-dc43235a0b28,bank_a_00.uk,Trader Joe's,2018-09-07,1034034.74,-504.27,food,Alice Johnson,CURRENT
2ebc1d42-54cb-4e23-bc2b-2129b72f54c3,bank_a_00.uk,Dr. Martins,2018-09-09,1032699.34,-1335.40,health,Alice Johnson,CURRENT
9628f788-1d78-438f-8471-264092277b19,bank_a_00.uk,Amazon.com,2018-09-11,1032459.61,-239.73,gift,Alice Johnson,CURRENT
3d404f51-9c7f-4c0f-9681-672959c8dc76,bank_a_00.uk,Trader Joe's,2018-09-14,1031889.10,-570.51,food,Alice Johnson,CURRENT
89103bcb-61e7-4e90-be0d-bca562415ced,bank_a_00.uk,Tuition,2018-09-14,1031094.99,-794.11,education,Alice Johnson,CURRENT
836c40ea-f1f5-406a-a320-6d09763d319c,bank_a_00.uk,Jiffy Lube,2018-09-16,1030041.53,-1053.46,auto,Alice Johnson,CURRENT
41a8fd79-96c4-4f0f-bcd4-491b1eb255bc,bank_a_00.uk,Trader Joe's,2018-09-17,1029401.69,-639.84,food,Alice Johnson,CURRENT
83e12a5e-43c7-4e2f-af00-74983acced80,bank_a_00.uk,Trader Joe's,2018-09-25,1029084.91,-316.78,food,Alice Johnson,CURRENT
ea693322-475f-4df5-9767-34140b0ad2ad,bank_a_00.uk,Metreon Theaters,2018-09-25,1028314.98,-769.93,entertainment,Alice Johnson,CURRENT
6325c532-2fa2-4972-98ba-71551dc40727,bank_a_00.uk,Late Fee,2018-09-27,1027941.24,-373.74,fee,Alice Johnson,CURRENT
5b9d1b42-23f7-4cd9-a7eb-2e9a1675d8f6,bank_a_00.uk,INCOME,2018-09-29,759474.43,33000.00,INCOME,John Smith,CURRENT
0069322e-bff3-4bef-afbb-c7d5b76a6c8c,bank_a_00.uk,In-N-Out Burger,2018-09-29,758953.37,-521.06,food,John Smith,CURRENT
c5fad3d1-9705-4143-997f-d321f9f885ce,bank_a_00.uk,In-N-Out Burger,2018-10-03,758297.82,-655.55,food,John Smith,CURRENT
cd24f9e9-505b-40cf-87b5-b842c94fa24a,bank_a_00.uk,The Gap,2018-10-03,757180.35,-1117.47,clothing,John Smith,CURRENT
5d8710e2-fb58-4ff8-8d98-7b5498c53edc,bank_a_00.uk,In-N-Out Burger,2018-10-04,756753.48,-426.87,food,John Smith,CURRENT
58bc0a3b-782d-4a38-98d4-d8884aa1af20,bank_a_00.uk,Verizon,2018-10-05,754647.57,-2105.91,utility,John Smith,CURRENT
48d68194-962f-47f0-aed9-10a348f5852b,bank_a_00.uk,Campus Books,2018-10-07,753728.13,-919.44,education,John Smith,CURRENT
17f412c0-63da-4828-96dd-f0963828c5fd,bank_a_00.uk,K&L Wines,2018-10-09,753317.30,-410.83,gift,John Smith,CURRENT
b0301e8c-b9a5-422f-99d8-016d6e8c5527,bank_a_00.uk,Dr. Phillips,2018-10-13,751983.85,-1333.45,health,John Smith,CURRENT
942102d6-72a3-45b1-a271-18184cb82913,bank_a_00.uk,In-N-Out Burger,2018-10-14,751342.76,-641.09,food,John Smith,CURRENT
3d661696-a732-494a-a04d-6a5e00c6971e,bank_a_00.uk,iTunes Music Store,2018-10-18,750617.14,-725.62,entertainment,John Smith,CURRENT
3e45302a-72a3-43f1-a389-839e48119ab4,bank_a_00.uk,In-N-Out Burger,2018-10-19,749976.21,-640.93,food,John Smith,CURRENT
da49e26b-4d20-4e46-ae22-61b19ec52e0e,bank_a_00.uk,In-N-Out Burger,2018-10-24,749509.13,-467.08,food,John Smith,CURRENT
5c467daf-4c63-4576-b14d-91602bfe7169,bank_a_02.uk,INCOME,2018-09-29,2900000.00,30000.00,INCOME,John Smith,SAVING
4a1c7560-39fb-4c0b-81c2-cf274fbd0aae,bank_a_00.uk,INCOME,2018-09-29,1200000.00,20000.00,INCOME,Alice Johnson,SAVING
048665f7-b6fd-4d08-a03e-135a60192045,bank_a_00.uk,INCOME,2018-09-29,1087941.24,60000.00,INCOME,Alice Johnson,CURRENT
079b783d-e966-470f-aa57-2750458b933d,bank_a_00.uk,RENT,2018-09-29,1067941.24,-20000.00,RENT,Alice Johnson,CURRENT
5d7a71da-e638-4920-b90d-577be6e91060,bank_a_00.uk,In-N-Out Burger,2018-09-30,1067420.71,-520.53,food,Alice Johnson,CURRENT
fcc4298b-a1c3-4440-bdc6-7f46cea58fc3,bank_a_00.uk,Nordstrom,2018-10-01,1067032.90,-387.81,gift,Alice Johnson,CURRENT
cbb06e23-cb18-483d-9bdc-27c9ec142b78,bank_a_00.uk,In-N-Out Burger,2018-10-02,1066332.11,-700.79,food,Alice Johnson,CURRENT
1ab15979-6989-4aaa-9530-b913bb350f36,bank_a_00.uk,Brinks,2018-10-05,1064243.76,-2088.35,utility,Alice Johnson,CURRENT
b32d6d56-7d70-4f23-8890-311e3ecb1b56,bank_a_00.uk,Shell,2018-10-11,1062595.38,-1648.38,auto,Alice Johnson,CURRENT
7cf5a995-d6b7-4987-a6ec-e50ec29f487a,bank_a_00.uk,iTunes Music Store,2018-10-19,1061795.53,-799.85,entertainment,Alice Johnson,CURRENT
5caaa7f6-9bf3-4684-8246-a9f34d5df8ab,bank_a_00.uk,In-N-Out Burger,2018-10-21,1061280.15,-515.38,food,Alice Johnson,CURRENT
8daf5d64-2571-4b04-8c0c-a398c142bd9b,bank_a_00.uk,Tuition,2018-10-25,1060425.92,-854.23,education,Alice Johnson,CURRENT
79af9a2e-823b-496f-a466-82b7e09ec4c1,bank_a_00.uk,Nordstrom,2018-10-27,1059394.02,-1031.90,clothing,Alice Johnson,CURRENT
68945f13-5877-4443-ba25-e5168040b284,bank_a_00.uk,In-N-Out Burger,2018-10-29,1058945.56,-448.46,food,Alice Johnson,CURRENT
cf906816-5edd-4ea6-bec8-ec4ab6663eae,bank_a_00.uk,INCOME,2018-10-29,782509.13,33000.00,INCOME,John Smith,CURRENT
d6ca78c7-c858-4f8f-89fd-331692a24e22,bank_a_00.uk,Trader Joe's,2018-10-29,782108.54,-400.59,food,John Smith,CURRENT
6d407a18-93ea-42e9-a6aa-f44585728a91,bank_a_00.uk,Pep Boys,2018-10-31,780429.82,-1678.72,auto,John Smith,CURRENT
1ed1c792-99b0-4f3f-ae9e-5a37397a3f37,bank_a_00.uk,Apple Store,2018-11-07,780015.82,-414.00,gift,John Smith,CURRENT
ba8533ca-cc8a-4394-bd45-4eeb8be09146,bank_a_00.uk,Trader Joe's,2018-11-09,779697.03,-318.79,food,John Smith,CURRENT
fa1bfadc-db9a-445c-8897-3e2711ae96c7,bank_a_00.uk,AMC Theaters,2018-11-13,779062.55,-634.48,entertainment,John Smith,CURRENT
6a18d640-9417-48c0-a6c0-8ae8b2919110,bank_a_00.uk,Brinks,2018-11-19,777743.45,-1319.10,utility,John Smith,CURRENT
e380b04a-136f-49ed-b560-1cdc51dfd65e,bank_a_00.uk,Overlimit Fee,2018-11-19,777425.43,-318.02,fee,John Smith,CURRENT
cf0cf54c-23af-4aed-be3d-35251e800773,bank_a_00.uk,Trader Joe's,2018-11-21,777004.49,-420.94,food,John Smith,CURRENT
1babbd5a-ca4c-4aff-ab32-2b24546847b9,bank_a_00.uk,Trader Joe's,2018-11-21,776669.18,-335.31,food,John Smith,CURRENT
988240c2-cafb-4fb4-b693-c16c9970c370,bank_a_00.uk,Trader Joe's,2018-11-23,776261.85,-407.33,food,John Smith,CURRENT
31cbe183-05ea-4dfb-beac-7abc3966fdaa,bank_a_00.uk,Wal-Mart,2018-11-23,774303.79,-1958.06,health,John Smith,CURRENT
722ba595-ba7e-4693-b7a3-5e342cadd33a,bank_a_00.uk,Nordstrom,2018-11-24,773160.65,-1143.14,clothing,John Smith,CURRENT
1738b06a-f952-42ea-bc1a-b99be4674d46,bank_a_00.uk,Trader Joe's,2018-11-25,772685.91,-474.74,food,John Smith,CURRENT
e4235aef-1286-4d07-a1ad-5f2c58744287,bank_a_02.uk,INCOME,2018-10-29,2930000.00,30000.00,INCOME,John Smith,SAVING
3e7a57c5-476d-413b-a3fc-309d69b51913,bank_a_00.uk,INCOME,2018-10-29,1220000.00,20000.00,INCOME,Alice Johnson,SAVING
3007cd8f-7d31-4148-b61c-5e825d9ef919,bank_a_00.uk,INCOME,2018-10-29,1118945.56,60000.00,INCOME,Alice Johnson,CURRENT
2fe4ccc6-83e9-4a76-a5fe-ba0d61198f1d,bank_a_00.uk,RENT,2018-10-29,1098945.56,-20000.00,RENT,Alice Johnson,CURRENT
91adc680-4134-4096-9f36-ed7a8a4fda44,bank_a_00.uk,Trader Joe's,2018-11-07,1098413.62,-531.94,food,Alice Johnson,CURRENT
e1069f25-1b93-4a40-a0e9-b99e75588b05,bank_a_00.uk,Bank Fee,2018-11-08,1098070.69,-342.93,fee,Alice Johnson,CURRENT
68739189-7263-4c26-b0f9-7096145f082a,bank_a_00.uk,Tuition,2018-11-14,1096698.00,-1372.69,education,Alice Johnson,CURRENT
624edd83-6572-4eff-ac2b-459524fac6d1,bank_a_00.uk,Trader Joe's,2018-11-16,1096266.86,-431.14,food,Alice Johnson,CURRENT
19a1e8c3-ef59-4921-b076-3dbf1ab9638d,bank_a_00.uk,Nordstrom,2018-11-18,1095967.44,-299.42,gift,Alice Johnson,CURRENT
abc628a0-20d6-4689-ac2a-6111aeb8105b,bank_a_00.uk,Shell,2018-11-20,1094701.03,-1266.41,auto,Alice Johnson,CURRENT
2f8794f2-1ad7-4384-9bc4-7cac2f34174c,bank_a_00.uk,Trader Joe's,2018-11-22,1094203.37,-497.66,food,Alice Johnson,CURRENT
e50f2eb6-797c-43c4-8724-3e87ae8878d0,bank_a_00.uk,Metreon Theaters,2018-11-23,1093487.61,-715.76,entertainment,Alice Johnson,CURRENT
167c0e33-a7ab-4cb8-8dc1-0018f27303ae,bank_a_00.uk,Banana Republic,2018-11-24,1092766.94,-720.67,clothing,Alice Johnson,CURRENT
6138d877-b131-483a-ab13-165f3498ed48,bank_a_00.uk,Dr. Phillips,2018-11-25,1091446.08,-1320.86,health,Alice Johnson,CURRENT
45c41a27-ae85-422f-9b72-97e8169f56f1,bank_a_00.uk,Trader Joe's,2018-11-28,1090991.72,-454.36,food,Alice Johnson,CURRENT
f1510ac1-b25b-44eb-a892-fd6b9e7b8dc3,bank_a_00.uk,INCOME,2018-11-28,805685.91,33000.00,INCOME,John Smith,CURRENT
1da72bfe-bdf8-4f8e-a88c-c15389af3dd4,bank_a_00.uk,Trader Joe's,2018-11-28,805206.44,-479.47,food,John Smith,CURRENT
e5b6f8a5-24ec-4b21-87ab-a70f6da37cef,bank_a_00.uk,Amazon.com,2018-12-12,804484.57,-721.87,entertainment,John Smith,CURRENT
d80a1349-9e60-42ad-8573-9166293bd3a5,bank_a_00.uk,Union 76,2018-12-13,802639.70,-1844.87,auto,John Smith,CURRENT
50fee412-1fbd-49fd-9244-60424cf0b667,bank_a_00.uk,Trader Joe's,2018-12-15,802321.26,-318.44,food,John Smith,CURRENT
4e6dc84b-fdaf-445f-a97a-68863163df56,bank_a_00.uk,K&L Wines,2018-12-19,801850.08,-471.18,gift,John Smith,CURRENT
eaf63911-fc9d-4029-a6db-0fa9dad8fe34,bank_a_00.uk,Dr. Phillips,2018-12-21,800382.08,-1468.00,health,John Smith,CURRENT
e467da9b-8f7f-49e1-bb7b-1e340d5d50f0,bank_a_00.uk,Kenneth Cole,2018-12-26,799559.43,-822.65,clothing,John Smith,CURRENT
fac031a3-98ea-4066-9504-ffd7df8cef65,bank_a_00.uk,Trader Joe's,2018-12-28,799217.01,-342.42,food,John Smith,CURRENT
91a08e81-458a-411e-9018-95232f80206b,bank_a_00.uk,Trader Joe's,2018-12-28,798635.80,-581.21,food,John Smith,CURRENT
c61bba2e-58cd-4a0c-8bf8-4a6c64b59d47,bank_a_02.uk,INCOME,2018-11-28,2960000.00,30000.00,INCOME,John Smith,SAVING
ae437365-297b-4e57-a7bf-d44c5ebcefb0,bank_a_00.uk,INCOME,2018-11-28,1240000.00,20000.00,INCOME,Alice Johnson,SAVING
61e462a4-da9c-49fc-80c7-9333a363b542,bank_a_00.uk,INCOME,2018-11-28,1150991.72,60000.00,INCOME,Alice Johnson,CURRENT
1d60965c-5e1b-4e53-bc16-1b40d00208d1,bank_a_00.uk,RENT,2018-11-28,1130991.72,-20000.00,RENT,Alice Johnson,CURRENT
7eef1181-d407-4db8-9f0b-a0393f0ed142,bank_a_00.uk,Trader Joe's,2018-12-06,1130362.43,-629.29,food,Alice Johnson,CURRENT
aca813f9-a31e-4e96-88b9-7cf3299d4fbc,bank_a_00.uk,Trader Joe's,2018-12-11,1129921.51,-440.92,food,Alice Johnson,CURRENT
b1e35db7-7fc7-4078-b611-9759989a600f,bank_a_00.uk,Brinks,2018-12-14,1128015.07,-1906.44,utility,Alice Johnson,CURRENT
56943de5-a9ee-4697-bb7c-cb4b93c63764,bank_a_00.uk,Wal-Mart,2018-12-15,1126648.64,-1366.43,health,Alice Johnson,CURRENT
6e66d6c8-ee8f-4bb9-9207-1a4211628248,bank_a_00.uk,Neiman-Marcus,2018-12-15,1126130.59,-518.05,gift,Alice Johnson,CURRENT
6594fbfd-e058-490f-8225-a91fe43b96bd,bank_a_00.uk,Trader Joe's,2018-12-17,1125493.48,-637.11,food,Alice Johnson,CURRENT
c451d8d6-ef86-4ebc-9e58-4fae486ca90f,bank_a_00.uk,AMC Theaters,2018-12-17,1125083.94,-409.54,entertainment,Alice Johnson,CURRENT
c14dcc6f-b857-4d0f-9724-b34b644916f3,bank_a_00.uk,Trader Joe's,2018-12-19,1124432.24,-651.70,food,Alice Johnson,CURRENT
58ec76ec-f0de-4867-a8ab-4baa4d0c7233,bank_a_00.uk,Banana Republic,2018-12-22,1123082.26,-1349.98,clothing,Alice Johnson,CURRENT
f31f9fb1-8b6d-4f4a-9adb-c149e72ea340,bank_a_00.uk,Union 76,2018-12-26,1121151.77,-1930.49,auto,Alice Johnson,CURRENT
adc94ca0-b4b4-49f8-9b82-b071dd1b503a,bank_a_00.uk,Trader Joe's,2018-12-27,1120665.91,-485.86,food,Alice Johnson,CURRENT
57c85a94-a3b9-45aa-ab7d-6001c19bccc2,bank_a_00.uk,INCOME,2018-12-28,831635.80,33000.00,INCOME,John Smith,CURRENT
d2b1d064-a1f9-4ee5-992a-3ab3675082f5,bank_a_00.uk,Dr. Phillips,2018-12-31,830003.02,-1632.78,health,John Smith,CURRENT
ac61b671-ab57-4be1-a5db-297e7e7a2fea,bank_a_00.uk,Amazon.com,2018-12-31,829174.29,-828.73,entertainment,John Smith,CURRENT
9cf31225-5a30-4b71-9551-7fd6ac0d46ca,bank_a_00.uk,Olive Garden,2019-01-02,828753.02,-421.27,food,John Smith,CURRENT
22f85d0a-ed97-4040-8a86-f48603e92f73,bank_a_00.uk,Kenneth Cole,2019-01-04,827810.83,-942.19,clothing,John Smith,CURRENT
8b199a93-64be-4b7a-9c82-1418bd3e07b1,bank_a_00.uk,Olive Garden,2019-01-05,827097.18,-713.65,food,John Smith,CURRENT
8e9cb64e-367a-4849-9f2c-b5b769025d75,bank_a_00.uk,PG&E,2019-01-06,825713.55,-1383.63,utility,John Smith,CURRENT
af2d9dbe-f726-420f-ae99-78c16bf620ff,bank_a_00.uk,Olive Garden,2019-01-09,825144.82,-568.73,food,John Smith,CURRENT
ca3a346f-f793-4b61-93bb-b77175634b2c,bank_a_00.uk,Olive Garden,2019-01-13,824809.49,-335.33,food,John Smith,CURRENT
3108039b-64f2-4119-8818-596193882294,bank_a_00.uk,Union 76,2019-01-27,823845.77,-963.72,auto,John Smith,CURRENT
5dc05eba-d876-45af-bb44-d13bc754bb0a,bank_a_02.uk,INCOME,2018-12-28,2990000.00,30000.00,INCOME,John Smith,SAVING
dcd5938f-1a5f-42fb-bfc0-5b045a205eea,bank_a_00.uk,INCOME,2018-12-28,1260000.00,20000.00,INCOME,Alice Johnson,SAVING
611b2e31-7bb3-4bd7-b875-6fa78aa6df4d,bank_a_00.uk,INCOME,2018-12-28,1180665.91,60000.00,INCOME,Alice Johnson,CURRENT
10489b13-f768-4c44-8e7c-7a11348203c2,bank_a_00.uk,RENT,2018-12-28,1160665.91,-20000.00,RENT,Alice Johnson,CURRENT
2ceeafde-b75e-47a7-9763-e2a70529710f,bank_a_00.uk,Starbucks,2018-12-29,1160296.99,-368.92,food,Alice Johnson,CURRENT
28c29463-6f68-4c46-a071-74a8db76d375,bank_a_00.uk,Verizon,2018-12-31,1158831.53,-1465.46,utility,Alice Johnson,CURRENT
204a9a23-4f64-43fa-9c8c-1ff1d94c3d75,bank_a_00.uk,Annual Fee,2019-01-06,1158492.29,-339.24,fee,Alice Johnson,CURRENT
69d55edc-efae-4883-94f1-4c7089f8a771,bank_a_00.uk,Starbucks,2019-01-07,1158023.51,-468.78,food,Alice Johnson,CURRENT
d6dfbca2-5411-4330-85b6-6f4f60afb1f2,bank_a_00.uk,Kenneth Cole,2019-01-09,1156985.02,-1038.49,clothing,Alice Johnson,CURRENT
82d78632-521e-41f7-8330-104c6d760fe5,bank_a_00.uk,Starbucks,2019-01-13,1156628.16,-356.86,food,Alice Johnson,CURRENT
10bf4f41-d6e0-4baa-ae85-980d102e47aa,bank_a_00.uk,The Crucible,2019-01-14,1155074.38,-1553.78,education,Alice Johnson,CURRENT
0ddac1cf-72ae-4cf7-9cc1-bdcffcd44beb,bank_a_00.uk,iTunes Music Store,2019-01-15,1154378.00,-696.38,entertainment,Alice Johnson,CURRENT
122a9041-ed6d-4eee-b132-c8a3da50cbee,bank_a_00.uk,Starbucks,2019-01-16,1153749.18,-628.82,food,Alice Johnson,CURRENT
1e9ad6fb-04f7-4c01-a1a0-2b7953f56fea,bank_a_00.uk,Apple Store,2019-01-18,1153314.71,-434.47,gift,Alice Johnson,CURRENT
fee7174a-2327-4dbb-a065-19223de2d592,bank_a_00.uk,Union 76,2019-01-25,1151851.93,-1462.78,auto,Alice Johnson,CURRENT
f2741993-c9ee-4b3d-a46c-59b706f0355c,bank_a_00.uk,INCOME,2019-01-27,856845.77,33000.00,INCOME,John Smith,CURRENT
8bdeb7bb-6fa8-4d7b-af8d-7f8b8569f491,bank_a_00.uk,Starbucks,2019-01-28,856455.33,-390.44,food,John Smith,CURRENT
1e3d33d3-d1a6-4f83-b1c8-705c41d37987,bank_a_00.uk,K&L Wines,2019-01-29,856032.44,-422.89,gift,John Smith,CURRENT
44a732c2-d059-4dc8-94b1-614d0e0db440,bank_a_00.uk,Starbucks,2019-02-09,855370.30,-662.14,food,John Smith,CURRENT
a6f3c501-cf64-47d0-9781-95718a8c8f33,bank_a_00.uk,Comcast,2019-02-12,853210.96,-2159.34,utility,John Smith,CURRENT
abacf7a7-7a5b-4178-8e10-a508c78f07f0,bank_a_00.uk,Shell,2019-02-12,851997.94,-1213.02,auto,John Smith,CURRENT
01ef9fb0-4429-42ee-8706-671ed2057b85,bank_a_00.uk,Amazon.com,2019-02-13,851345.97,-651.97,entertainment,John Smith,CURRENT
41b815a1-eb18-4cc9-9d79-bcec1e4a0f21,bank_a_00.uk,Starbucks,2019-02-18,850998.09,-347.88,food,John Smith,CURRENT
9ef597c8-90ad-4a90-a79d-129b0967f480,bank_a_00.uk,Kenneth Cole,2019-02-19,849679.41,-1318.68,clothing,John Smith,CURRENT
9fb3a664-510d-42a8-86fa-b0f4a85386f9,bank_a_00.uk,Registration,2019-02-21,848294.64,-1384.77,education,John Smith,CURRENT
d753a353-e670-48b3-8a5e-26b6fcbbc58d,bank_a_00.uk,Starbucks,2019-02-24,847704.10,-590.54,food,John Smith,CURRENT
94d28b98-ec05-4a4b-afc1-d4fb16a10562,bank_a_00.uk,Starbucks,2019-02-25,847321.52,-382.58,food,John Smith,CURRENT
90319dd4-d6f0-45f0-b7a8-1ff04fa22f38,bank_a_02.uk,INCOME,2019-01-27,3020000.00,30000.00,INCOME,John Smith,SAVING
d9c586ef-a4ae-4564-b343-478cad6fb9fc,bank_a_00.uk,INCOME,2019-01-27,1280000.00,20000.00,INCOME,Alice Johnson,SAVING
a17f3437-b277-4524-8f13-5ce412454c4a,bank_a_00.uk,INCOME,2019-01-27,1211851.93,60000.00,INCOME,Alice Johnson,CURRENT
47cf5191-f4d9-4063-8e59-a02f44362815,bank_a_00.uk,RENT,2019-01-27,1191851.93,-20000.00,RENT,Alice Johnson,CURRENT
0d57f4bd-fbdf-4282-8905-172dc14d7029,bank_a_00.uk,Verizon,2019-01-30,1189382.38,-2469.55,utility,Alice Johnson,CURRENT
ead43fa2-34bd-488d-9448-8a651e2f0de1,bank_a_00.uk,Chevron,2019-01-30,1187894.01,-1488.37,auto,Alice Johnson,CURRENT
e0d79068-81f2-4ddd-bc64-d6ed8a7d1d19,bank_a_00.uk,Apple Store,2019-01-30,1187497.52,-396.49,gift,Alice Johnson,CURRENT
f2508b45-188c-42be-bbb7-6de5196d16b8,bank_a_00.uk,Amazon.com,2019-01-31,1186933.29,-564.23,entertainment,Alice Johnson,CURRENT
f0ad6184-502c-4059-b730-730fb83f3354,bank_a_00.uk,Whole Foods,2019-02-04,1186432.43,-500.86,food,Alice Johnson,CURRENT
bd53b9e1-7bc1-4861-904a-fb1ad7777b68,bank_a_00.uk,Macy's,2019-02-08,1185203.00,-1229.43,clothing,Alice Johnson,CURRENT
be672580-011f-4f7a-a52d-b29ed7e8ed79,bank_a_00.uk,Whole Foods,2019-02-09,1184586.85,-616.15,food,Alice Johnson,CURRENT
37a09d29-e72a-4fca-a0ac-7e01d795d4db,bank_a_00.uk,The Crucible,2019-02-11,1183530.82,-1056.03,education,Alice Johnson,CURRENT
4a4813b2-5ff8-4cbe-8e61-dd52d30383b5,bank_a_00.uk,Whole Foods,2019-02-13,1182927.20,-603.62,food,Alice Johnson,CURRENT
fee49433-8dd1-4adb-97f0-c1da2c9f4cfb,bank_a_00.uk,Wal-Mart,2019-02-24,1181654.02,-1273.18,health,Alice Johnson,CURRENT
462c9753-c5d6-4ea1-a5fd-8003afbc042d,bank_a_00.uk,Whole Foods,2019-02-25,1181047.51,-606.51,food,Alice Johnson,CURRENT
87bedd09-7901-4274-b34d-d6e91f7bba23,bank_a_00.uk,INCOME,2019-02-26,880321.52,33000.00,INCOME,John Smith,CURRENT
64021011-e0b2-442c-90d5-f86636b3e405,bank_a_00.uk,Netflix,2019-02-27,879952.61,-368.91,entertainment,John Smith,CURRENT
b278bad5-b4ff-4935-bbce-598f850b0cca,bank_a_00.uk,Whole Foods,2019-03-06,879460.38,-492.23,food,John Smith,CURRENT
3f8ef3bb-8b16-48f4-a39d-4c47acfca5e6,bank_a_00.uk,Whole Foods,2019-03-09,879145.45,-314.93,food,John Smith,CURRENT
7957436e-095f-4961-a08f-ecbf3bdc07ed,bank_a_00.uk,Whole Foods,2019-03-15,878596.56,-548.89,food,John Smith,CURRENT
d51f7da3-6b30-4526-ae7f-1ee3b49b0daf,bank_a_00.uk,Dr. Phillips,2019-03-18,876576.03,-2020.53,health,John Smith,CURRENT
cd504962-d280-4095-8a75-b2707ea662e0,bank_a_00.uk,Kenneth Cole,2019-03-19,875193.30,-1382.73,clothing,John Smith,CURRENT
9b271cc1-89a0-42e6-bace-cd1527a1cc7c,bank_a_00.uk,Bank Fee,2019-03-19,874921.03,-272.27,fee,John Smith,CURRENT
2ab9f975-ebdb-4c98-8fca-2cd7d9fbea5e,bank_a_00.uk,AT&T,2019-03-20,873338.54,-1582.49,utility,John Smith,CURRENT
fe65d5c0-53ad-468f-9a86-6813311dfa7c,bank_a_00.uk,Whole Foods,2019-03-23,872892.12,-446.42,food,John Smith,CURRENT
a663fc2b-192e-4865-8163-679c05a5e22e,bank_a_00.uk,Amazon.com,2019-03-28,871414.23,-1477.89,education,John Smith,CURRENT
f17cf335-0d50-4942-b4fe-69e7dabaaa80,bank_a_02.uk,INCOME,2019-02-26,3050000.00,30000.00,INCOME,John Smith,SAVING
69a46f04-3dbf-49ac-93d7-73290cb2c4b1,bank_a_00.uk,INCOME,2019-02-26,1300000.00,20000.00,INCOME,Alice Johnson,SAVING
454d7586-2905-4ff5-82f7-4c0a4a9558e6,bank_a_00.uk,INCOME,2019-02-26,1241047.51,60000.00,INCOME,Alice Johnson,CURRENT
d0125ea0-5504-411d-b06c-2c358e4346af,bank_a_00.uk,RENT,2019-02-26,1221047.51,-20000.00,RENT,Alice Johnson,CURRENT
bc6a5ea3-0e71-4954-abdd-81df0b7fc179,bank_a_00.uk,Starbucks,2019-02-28,1220545.16,-502.35,food,Alice Johnson,CURRENT
c02fd0c1-1d08-4747-9b44-f124c6db94d7,bank_a_00.uk,Annual Fee,2019-03-01,1220122.10,-423.06,fee,Alice Johnson,CURRENT
513f6f5f-fd3e-4024-8026-a9145016e510,bank_a_00.uk,Dr. Martins,2019-03-02,1218626.10,-1496.00,health,Alice Johnson,CURRENT
37b308b2-609a-49d1-a549-46ba2eaae3b3,bank_a_00.uk,Amazon.com,2019-03-05,1217751.24,-874.86,education,Alice Johnson,CURRENT
14fd6cdf-e850-4912-a48c-801550871343,bank_a_00.uk,Amazon.com,2019-03-06,1217358.18,-393.06,gift,Alice Johnson,CURRENT
ecc1b473-e5e8-4a9b-aa83-041b6c4c4bf0,bank_a_00.uk,Union 76,2019-03-07,1215789.87,-1568.31,auto,Alice Johnson,CURRENT
4ade8d49-4bbd-474c-bb6c-e08d607c5b65,bank_a_00.uk,Starbucks,2019-03-08,1215271.64,-518.23,food,Alice Johnson,CURRENT
06847ccf-5a90-4ac3-aa42-c57d8f4d3b6b,bank_a_00.uk,Amazon.com,2019-03-10,1214621.28,-650.36,entertainment,Alice Johnson,CURRENT
8458370a-275c-4da8-917b-2b08f788ce66,bank_a_00.uk,Starbucks,2019-03-12,1214233.67,-387.61,food,Alice Johnson,CURRENT
de9e4a7e-d536-4e58-80b1-aa10e8ddea2f,bank_a_00.uk,Starbucks,2019-03-16,1213736.63,-497.04,food,Alice Johnson,CURRENT
f3692c49-3833-4620-95d0-2f585d62ef87,bank_a_00.uk,Macy's,2019-03-23,1212412.92,-1323.71,clothing,Alice Johnson,CURRENT
8d2e7122-26e8-4b1a-9d50-7478633d6b6c,bank_a_00.uk,INCOME,2019-03-28,904414.23,33000.00,INCOME,John Smith,CURRENT
1d119c6b-996e-4569-886b-4411800340cf,bank_a_00.uk,Kenneth Cole,2019-03-30,903039.32,-1374.91,clothing,John Smith,CURRENT
b918e6e8-db25-434a-ae03-1939dcf6d74b,bank_a_00.uk,iTunes Music Store,2019-03-30,902616.59,-422.73,entertainment,John Smith,CURRENT
63147a64-4d1e-490b-a45c-bae5447c28bd,bank_a_00.uk,Dr. Martins,2019-04-02,900776.54,-1840.05,health,John Smith,CURRENT
d83e4c10-ec20-4fb7-add2-80ca2ac992f8,bank_a_00.uk,Trader Joe's,2019-04-03,900195.23,-581.31,food,John Smith,CURRENT
2dc8c370-bd32-4979-a8ba-ae2da7ae31bd,bank_a_00.uk,Trader Joe's,2019-04-14,899609.97,-585.26,food,John Smith,CURRENT
c81f76a2-4264-43d3-a1eb-49dcd15863a8,bank_a_00.uk,Shell,2019-04-16,898287.11,-1322.86,auto,John Smith,CURRENT
2e922ad4-63c9-4ab0-9b3e-3ee8b3f553fb,bank_a_00.uk,Trader Joe's,2019-04-17,897610.86,-676.25,food,John Smith,CURRENT
fd374cd7-7d01-4cc1-972b-daaf669f7630,bank_a_00.uk,Trader Joe's,2019-04-18,897211.34,-399.52,food,John Smith,CURRENT
8a583fdf-30fb-40cc-b235-4ed15d8e9924,bank_a_00.uk,Trader Joe's,2019-04-24,896598.35,-612.99,food,John Smith,CURRENT
6854d0e7-b17a-4051-b93c-6e3d7b4c01dc,bank_a_02.uk,INCOME,2019-03-28,3080000.00,30000.00,INCOME,John Smith,SAVING
fd4adfa6-b71a-40bb-b77b-76bde76bf490,bank_a_00.uk,INCOME,2019-03-28,1320000.00,20000.00,INCOME,Alice Johnson,SAVING
9211dd3c-4694-49c8-8610-913f1c51ffc7,bank_a_00.uk,INCOME,2019-03-28,1272412.92,60000.00,INCOME,Alice Johnson,CURRENT
724ec508-72cd-4d6c-b6e1-eb8819c4fd43,bank_a_00.uk,RENT,2019-03-28,1252412.92,-20000.00,RENT,Alice Johnson,CURRENT
eb9b1c53-3e1c-41bc-8137-5428574eef78,bank_a_00.uk,Shell,2019-03-30,1250913.55,-1499.37,auto,Alice Johnson,CURRENT
b0d69de8-3467-4eec-b093-57b9e2237f77,bank_a_00.uk,Bank Fee,2019-03-30,1250440.60,-472.95,fee,Alice Johnson,CURRENT
3ad64806-9810-4990-b2be-958d953f6f3a,bank_a_00.uk,iTunes Music Store,2019-03-31,1249983.55,-457.05,entertainment,Alice Johnson,CURRENT
816a4cb2-3af3-4ea6-9417-14504b7b99b8,bank_a_00.uk,In-N-Out Burger,2019-04-02,1249674.84,-308.71,food,Alice Johnson,CURRENT
4c9ab8cc-5f79-4bed-874a-d218fb88aaeb,bank_a_00.uk,Kenneth Cole,2019-04-02,1248933.12,-741.72,clothing,Alice Johnson,CURRENT
68d41cf0-69a8-4fee-bdd2-27e00612f2d5,bank_a_00.uk,Dr. Roberts,2019-04-04,1247844.38,-1088.74,health,Alice Johnson,CURRENT
69392789-2f3a-46e6-b3b0-601383a0df6b,bank_a_00.uk,In-N-Out Burger,2019-04-07,1247285.80,-558.58,food,Alice Johnson,CURRENT
36385521-bc49-42eb-ba4f-f407523a7a2c,bank_a_00.uk,Nordstrom,2019-04-09,1246892.69,-393.11,gift,Alice Johnson,CURRENT
b4846837-ddf6-4474-945e-a5e5fb2850d5,bank_a_00.uk,In-N-Out Burger,2019-04-14,1246281.72,-610.97,food,Alice Johnson,CURRENT
2e9e630a-97c8-4f68-b4ef-7337f6f28312,bank_a_00.uk,In-N-Out Burger,2019-04-14,1245951.98,-329.74,food,Alice Johnson,CURRENT
e683af46-52d0-4bb8-b092-ed65ccad3c84,bank_a_00.uk,Registration,2019-04-24,1244894.38,-1057.60,education,Alice Johnson,CURRENT
